Year,Country_of_asylum,Total_recognized_decisions,Total_complementary_protection,Total_rejected_decisions,Total_closed_decisions,Total_asylum_decisions
2006,Afghanistan,0,0,5,10,15
2006,Albania,5,5,0,5,15
2006,Algeria,68,0,29,5,102
2006,Angola,134,5,183,0,322
2006,Argentina,50,0,235,5,290
2006,Armenia,0,256,10,327,593
2006,Australia,1249,0,4776,290,6315
2006,Austria,4051,891,5837,5537,16316
2006,Azerbaijan,405,0,300,38,743
2006,Bangladesh,0,0,0,19,19
2006,Belarus,5,10,75,20,110
2006,Belgium,2357,10,7021,3807,13195
2006,Belize,0,0,0,14,14
2006,Benin,224,0,459,783,1466
2006,Bolivia (Plurinational State of),30,0,0,5,35
2006,Bosnia and Herzegovina,10,0,74,92,176
2006,Botswana,55,0,0,0,55
2006,Brazil,194,5,444,97,740
2006,Bulgaria,10,77,209,268,564
2006,Burkina Faso,0,0,0,430,430
2006,Burundi,1099,0,8642,14519,24260
2006,Cambodia,77,0,280,36,393
2006,Cameroon,1421,0,2520,2488,6429
2006,Canada,9248,0,8082,2412,19742
2006,Central African Rep.,465,0,12,33,510
2006,Chad,0,5,148,0,153
2006,Chile,282,0,39,18,339
2006,China,21,0,27,32,80
2006,"China, Hong Kong SAR",45,0,808,813,1666
2006,Colombia,0,0,38,5,43
2006,Congo,36,0,153,114,303
2006,Costa Rica,443,0,0,0,443
2006,Cote d'Ivoire,54,0,365,0,419
2006,Croatia,0,0,80,10,90
2006,Cuba,23,0,0,0,23
2006,Cyprus,51,171,3611,3849,7682
2006,Czechia,362,0,3712,1380,5454
2006,Dem. Rep. of the Congo,17,0,5,99,121
2006,Denmark,189,97,1031,203,1520
2006,Djibouti,44,0,61,0,105
2006,Ecuador,1992,0,2700,49,4741
2006,Egypt,1281,0,344,171,1796
2006,El Salvador,0,0,0,5,5
2006,Eritrea,31,0,24,5,60
2006,Ethiopia,2700,0,0,0,2700
2006,Finland,32,593,1473,275,2373
2006,France,10891,895,59365,0,71151
2006,Gabon,0,0,206,951,1157
2006,Gambia,41,0,0,0,41
2006,Georgia,10,0,11,0,21
2006,Germany,1329,558,17755,11003,30645
2006,Ghana,0,0,5,5,10
2006,Greece,51,52,10406,2611,13120
2006,Guatemala,0,0,0,24,24
2006,Guinea,527,0,620,0,1147
2006,Guinea-Bissau,215,0,20,0,235
2006,Honduras,0,0,25,41,66
2006,Hungary,89,94,1091,579,1853
2006,Iceland,0,0,15,0,15
2006,India,548,0,255,226,1029
2006,Indonesia,97,5,20,67,189
2006,Iran (Islamic Rep. of),81,10,51,137,279
2006,Iraq,0,0,0,248,248
2006,Ireland,623,0,4821,664,6108
2006,Israel,0,338,784,260,1382
2006,Italy,1026,5308,7928,3596,17858
2006,Japan,33,50,459,73,615
2006,Jordan,182,0,400,1587,2169
2006,Kazakhstan,199,0,52,25,276
2006,Kenya,22935,0,2022,10845,35802
2006,Kuwait,13,0,5,67,85
2006,Kyrgyzstan,144,0,62,222,428
2006,Latvia,0,5,0,5,10
2006,Lebanon,120,63,601,38,822
2006,Liberia,0,0,0,25,25
2006,Libya,53,0,259,1456,1768
2006,Liechtenstein,0,36,15,20,71
2006,Lithuania,15,76,15,0,106
2006,Luxembourg,27,351,962,248,1588
2006,Malawi,208,0,612,3627,4447
2006,Malaysia,9312,0,563,849,10724
2006,Mali,48,0,48,0,96
2006,Malta,30,517,626,5,1178
2006,Mauritania,115,0,183,0,298
2006,Mexico,72,0,89,302,463
2006,Mongolia,5,0,0,0,5
2006,Montenegro,0,0,0,5,5
2006,Morocco,296,0,695,144,1135
2006,Mozambique,649,0,0,10,659
2006,Namibia,144,0,55,0,199
2006,Nepal,182,40,114,16,352
2006,Netherlands,347,5992,8647,4141,19127
2006,New Zealand,126,0,451,35,612
2006,Nicaragua,5,0,0,25,30
2006,Niger,5,0,10,20,35
2006,Nigeria,0,0,0,228,228
2006,North Macedonia,0,131,255,184,570
2006,Norway,499,1674,6287,1286,9746
2006,Pakistan,310,0,1546,905,2761
2006,Panama,138,0,45,428,611
2006,Paraguay,14,0,0,5,19
2006,Peru,73,0,17,42,132
2006,Philippines,5,0,0,10,15
2006,Poland,475,2101,1183,3905,7664
2006,Portugal,20,0,55,0,75
2006,Rep. of Korea,10,15,97,36,158
2006,Rep. of Moldova,10,66,20,30,126
2006,Romania,46,0,247,214,507
2006,Russian Federation,35,0,1120,0,1155
2006,Rwanda,158,0,10,208,376
2006,Saudi Arabia,15,0,20,0,35
2006,Senegal,10,0,243,0,253
2006,Serbia and Kosovo: S/RES/1244 (1999),0,0,20,20,40
2006,Sierra Leone,67,0,65,55,187
2006,Slovakia,5,0,866,1944,2815
2006,Slovenia,0,5,545,302,852
2006,Somalia,117,0,178,0,295
2006,South Africa,5462,0,29188,0,34650
2006,Spain,147,166,1462,2347,4122
2006,Sri Lanka,76,0,51,25,152
2006,Sudan,9790,0,45,332,10167
2006,Sweden,610,6471,6993,3873,17947
2006,Switzerland,3253,5189,9383,7779,25604
2006,Syrian Arab Rep.,1376,0,148,10,1534
2006,Tajikistan,46,0,187,0,233
2006,Thailand,537,15762,560,1547,18406
2006,Timor-Leste,0,0,0,5,5
2006,Togo,60,0,27,0,87
2006,Tunisia,10,0,0,15,25
2006,Turkey,1888,0,696,1135,3719
2006,Turkmenistan,5,0,10,0,15
2006,Uganda,3642,0,1763,0,5405
2006,Ukraine,52,0,1019,2317,3388
2006,United Arab Emirates,129,0,16,10,155
2006,United Kingdom of Great Britain and Northern Ireland,6250,2403,28413,6218,43284
2006,United Rep. of Tanzania,958,0,0,0,958
2006,United States of America,23258,0,39074,71662,133994
2006,Uzbekistan,0,0,0,581,581
2006,Venezuela (Bolivarian Republic of),336,0,49,0,385
2006,Yemen,738,0,277,525,1540
2006,Zambia,15,0,15,0,30
2006,Zimbabwe,571,0,22,2492,3085
2007,Afghanistan,10,0,0,10,20
2007,Albania,5,0,0,25,30
2007,Algeria,0,0,113,0,113
2007,Angola,79,0,59,0,138
2007,Argentina,54,0,218,20,292
2007,Armenia,0,253,10,16,279
2007,Australia,1662,0,4155,255,6072
2007,Austria,5192,1624,6643,4185,17644
2007,Azerbaijan,310,0,243,15,568
2007,Bangladesh,42,0,0,40,82
2007,Belarus,5,0,42,20,67
2007,Belgium,2672,433,7595,850,11550
2007,Benin,31,0,993,242,1266
2007,Bolivia (Plurinational State of),16,0,0,15,31
2007,Bosnia and Herzegovina,0,0,0,18,18
2007,Botswana,49,0,0,5,54
2007,Brazil,137,5,359,20,521
2007,Bulgaria,10,319,221,231,781
2007,Burkina Faso,40,0,59,133,232
2007,Burundi,167,0,405,687,1259
2007,Cambodia,134,0,290,39,463
2007,Cameroon,1495,0,1316,2013,4824
2007,Canada,5840,0,5412,2481,13733
2007,Central African Rep.,356,0,21,0,377
2007,Chad,0,0,35,0,35
2007,Chile,243,0,300,31,574
2007,China,107,0,5,30,142
2007,"China, Hong Kong SAR",15,5,1417,1289,2726
2007,Colombia,25,0,85,0,110
2007,Congo,62,0,209,0,271
2007,Costa Rica,176,0,517,0,693
2007,Cote d'Ivoire,35,0,483,183,701
2007,Croatia,0,0,97,80,177
2007,Cuba,15,0,10,5,30
2007,Cyprus,38,225,4203,5043,9509
2007,Czechia,251,191,2373,844,3659
2007,Dem. Rep. of the Congo,5,0,15,40,60
2007,Denmark,92,121,560,0,773
2007,Ecuador,880,2116,5920,132,9048
2007,Egypt,1323,0,634,750,2707
2007,Eritrea,31,0,55,0,86
2007,Estonia,0,0,5,5,10
2007,Eswatini,39,0,0,0,39
2007,Ethiopia,19896,0,15,68,19979
2007,Finland,60,751,272,770,1853
2007,France,12922,1237,41876,5877,61912
2007,Gabon,23,0,110,23,156
2007,Gambia,0,0,0,600,600
2007,Georgia,10,0,5,0,15
2007,Germany,7171,651,12732,7938,28492
2007,Ghana,16,0,0,5236,5252
2007,Greece,138,15,26209,877,27239
2007,Guatemala,0,0,22,27,49
2007,Guinea,368,0,218,0,586
2007,Guinea-Bissau,70,0,31,0,101
2007,Honduras,0,0,0,15,15
2007,Hungary,152,51,1171,471,1845
2007,Iceland,0,0,0,20,20
2007,India,747,0,334,72,1153
2007,Indonesia,132,0,43,139,314
2007,Iran (Islamic Rep. of),10,5,169,345,529
2007,Ireland,543,0,4101,914,5558
2007,Israel,0,0,343,125,468
2007,Italy,1506,10291,5453,4381,21631
2007,Japan,41,84,748,86,959
2007,Jordan,60,0,15,57,132
2007,Kazakhstan,175,0,46,37,258
2007,Kenya,3088,0,1581,27545,32214
2007,Kuwait,122,0,0,122,244
2007,Kyrgyzstan,170,0,130,311,611
2007,Latvia,5,0,0,0,5
2007,Lebanon,101,2293,352,70,2816
2007,Liberia,0,0,0,10,10
2007,Libya,1383,0,327,134,1844
2007,Liechtenstein,0,5,5,15,25
2007,Lithuania,10,47,43,31,131
2007,Luxembourg,140,391,848,186,1565
2007,Malawi,162,0,1801,3508,5471
2007,Malaysia,14144,0,752,1212,16108
2007,Mali,57,0,28,0,85
2007,Malta,5,619,596,10,1230
2007,Mauritania,206,0,413,20,639
2007,Mexico,73,0,121,225,419
2007,Mongolia,0,0,0,5,5
2007,Montenegro,0,0,0,10,10
2007,Morocco,283,0,1347,636,2266
2007,Mozambique,128,0,150,750,1028
2007,Namibia,0,10,98,226,334
2007,Nepal,20,0,59,1389,1468
2007,Netherlands,670,5007,4647,4958,15282
2007,New Zealand,100,0,289,20,409
2007,Nicaragua,5,0,0,32,37
2007,Niger,5,0,5,0,10
2007,Nigeria,19,0,115,130,264
2007,North Macedonia,0,5,55,5,65
2007,Norway,1050,3409,5549,2225,12233
2007,Pakistan,659,0,741,340,1740
2007,Panama,48,0,23,0,71
2007,Paraguay,10,0,5,5,20
2007,Peru,102,0,70,40,212
2007,Philippines,10,0,5,10,25
2007,Poland,207,2904,2330,1451,6892
2007,Portugal,0,28,68,0,96
2007,Rep. of Korea,10,10,83,64,167
2007,Rep. of Moldova,0,20,30,5,55
2007,Romania,127,15,376,110,628
2007,Russian Federation,140,391,0,0,531
2007,Rwanda,226,3056,0,0,3282
2007,Saudi Arabia,0,0,42,0,42
2007,Senegal,10,0,278,0,288
2007,Serbia and Kosovo: S/RES/1244 (1999),10,0,0,15,25
2007,Sierra Leone,0,5,0,0,5
2007,Singapore,15,0,5,10,30
2007,Slovakia,10,73,1164,1686,2933
2007,Slovenia,0,5,295,235,535
2007,Somalia,202,0,287,165,654
2007,South Africa,1730,0,4134,0,5864
2007,Spain,226,5,5126,0,5357
2007,Sri Lanka,47,0,51,45,143
2007,Sudan,11384,18,41,2268,13711
2007,Sweden,1075,15320,16740,8803,41938
2007,Switzerland,1552,2733,3265,4704,12254
2007,Syrian Arab Rep.,1344,0,187,15,1546
2007,Tajikistan,325,0,516,0,841
2007,Thailand,506,2657,239,2964,6366
2007,Togo,0,0,41,343,384
2007,Trinidad and Tobago,0,0,5,0,5
2007,Tunisia,20,0,31,59,110
2007,Turkey,7056,0,504,1799,9359
2007,Uganda,3079,0,1484,0,4563
2007,Ukraine,32,0,560,2034,2626
2007,United Arab Emirates,93,0,0,5,98
2007,United Kingdom of Great Britain and Northern Ireland,8217,2479,27862,8044,46602
2007,United Rep. of Tanzania,1018,0,0,0,1018
2007,United States of America,17961,0,34321,43393,95675
2007,Uruguay,20,0,0,0,20
2007,Venezuela (Bolivarian Republic of),228,0,287,0,515
2007,Yemen,2690,0,291,131,3112
2007,Zambia,47,5,51,32,135
2007,Zimbabwe,770,0,12,3320,4102
2008,Afghanistan,0,0,0,10,10
2008,Albania,0,0,0,5,5
2008,Algeria,25,0,45,687,757
2008,Angola,93,0,84,0,177
2008,Argentina,98,0,431,129,658
2008,Armenia,0,122,0,5,127
2008,Australia,1818,0,4440,304,6562
2008,Austria,3752,1604,7936,3582,16874
2008,Azerbaijan,193,0,236,0,429
2008,Bahrain,48,0,0,0,48
2008,Bangladesh,80,0,60,10,150
2008,Belarus,10,5,20,25,60
2008,Belgium,3019,479,7567,736,11801
2008,Benin,103,0,753,180,1036
2008,Bolivia (Plurinational State of),30,0,15,70,115
2008,Bosnia and Herzegovina,0,0,35,193,228
2008,Botswana,747,0,0,0,747
2008,Brazil,87,15,194,180,476
2008,Bulgaria,26,261,365,62,714
2008,Burkina Faso,24,0,34,0,58
2008,Burundi,3274,0,311,2286,5871
2008,Cambodia,51,0,550,86,687
2008,Cameroon,1101,0,1170,1685,3956
2008,Canada,7541,0,6778,3736,18055
2008,Central African Rep.,431,0,0,951,1382
2008,Chad,0,0,100,0,100
2008,Chile,119,0,368,5,492
2008,China,26,0,20,33,79
2008,"China, Hong Kong SAR",41,0,1565,448,2054
2008,Colombia,5,0,99,0,104
2008,Congo,26,0,434,3058,3518
2008,Costa Rica,388,0,621,0,1009
2008,Cote d'Ivoire,21,0,228,1322,1571
2008,Croatia,0,5,68,90,163
2008,Cuba,0,0,5,0,5
2008,Cyprus,85,178,6389,4103,10755
2008,Czechia,195,133,1870,1049,3247
2008,Dem. Rep. of the Congo,0,0,5,41,46
2008,Denmark,274,343,767,0,1384
2008,Djibouti,73,20,0,156,249
2008,Ecuador,35,4421,6319,305,11080
2008,Egypt,1099,0,847,777,2723
2008,El Salvador,0,0,0,5,5
2008,Eritrea,0,0,0,1963,1963
2008,Ethiopia,16931,0,2531,2763,22225
2008,Finland,91,675,233,955,1954
2008,France,14841,2910,41136,4246,63133
2008,Gabon,10,0,20,216,246
2008,Georgia,19,0,0,5,24
2008,Germany,7273,528,6729,6175,20705
2008,Ghana,41,0,27,20,88
2008,Greece,356,19,23328,371,24074
2008,Guatemala,0,0,5,0,5
2008,Guinea,18,0,5,3702,3725
2008,Guinea-Bissau,23,0,81,10,114
2008,Honduras,5,0,0,56,61
2008,Hungary,140,128,388,1465,2121
2008,Iceland,5,5,10,30,50
2008,India,1318,0,530,287,2135
2008,Indonesia,174,0,10,45,229
2008,Iran (Islamic Rep. of),118,0,65,186,369
2008,Iraq,0,0,0,641,641
2008,Ireland,565,0,4950,1288,6803
2008,Israel,0,8418,997,546,9961
2008,Italy,1780,8222,10360,1042,21404
2008,Japan,59,362,1086,105,1612
2008,Jordan,138,49,55,136,378
2008,Kazakhstan,129,0,61,10,200
2008,Kenya,2923,0,642,2244,5809
2008,Kuwait,104,0,10,15,129
2008,Kyrgyzstan,207,0,284,334,825
2008,Latvia,0,0,15,0,15
2008,Lebanon,66,5,276,95,442
2008,Liberia,37,0,0,22,59
2008,Libya,2397,344,185,89,3015
2008,Liechtenstein,0,0,0,10,10
2008,Lithuania,5,50,40,41,136
2008,Luxembourg,67,336,485,173,1061
2008,Malawi,1244,0,231,194,1669
2008,Malaysia,11357,0,310,2865,14532
2008,Mali,15,0,26,0,41
2008,Malta,20,1392,1459,15,2886
2008,Mauritania,67,0,167,23,257
2008,Mexico,91,0,86,133,310
2008,Mongolia,5,0,0,0,5
2008,Morocco,108,0,872,288,1268
2008,Mozambique,453,0,547,452,1452
2008,Namibia,31,0,132,5,168
2008,Nepal,42,684,10,31,767
2008,Netherlands,501,5144,5240,0,10885
2008,New Zealand,116,0,222,10,348
2008,Nicaragua,0,0,0,93,93
2008,Niger,5,0,5,0,10
2008,Nigeria,23,55,76,10,164
2008,North Macedonia,0,46,17,52,115
2008,Norway,1141,2572,8313,2258,14284
2008,Oman,5,0,0,0,5
2008,Pakistan,572,0,508,537,1617
2008,Panama,35,0,27,71,133
2008,Papua New Guinea,5,0,0,0,5
2008,Paraguay,10,0,0,10,20
2008,Peru,91,0,51,12,154
2008,Poland,181,2576,1565,5755,10077
2008,Portugal,15,61,25,0,101
2008,Qatar,5,0,0,16,21
2008,Rep. of Korea,28,21,66,98,213
2008,Rep. of Moldova,5,15,39,10,69
2008,Romania,109,0,834,67,1010
2008,Russian Federation,347,791,5552,0,6690
2008,Rwanda,21,0,38,328,387
2008,Saudi Arabia,55,10,27,101,193
2008,Senegal,0,0,90,0,90
2008,Serbia and Kosovo: S/RES/1244 (1999),0,11,10,22,43
2008,Sierra Leone,0,0,53,276,329
2008,Singapore,15,0,0,25,40
2008,Slovakia,20,58,401,444,923
2008,Slovenia,0,0,143,151,294
2008,Somalia,715,0,625,222,1562
2008,South Africa,7049,0,62065,0,69114
2008,Spain,149,128,2270,2608,5155
2008,Sri Lanka,127,0,43,56,226
2008,Sudan,5888,6725,64,24711,37388
2008,Sweden,1902,7052,28387,4556,41897
2008,Switzerland,2253,4309,4468,4300,15330
2008,Syrian Arab Rep.,1482,0,211,2895,4588
2008,Tajikistan,828,0,639,0,1467
2008,Thailand,1264,0,520,297,2081
2008,Togo,25,0,65,0,90
2008,Trinidad and Tobago,5,0,16,24,45
2008,Tunisia,0,0,24,41,65
2008,Turkey,8642,0,659,2521,11822
2008,Turkmenistan,0,0,16,0,16
2008,Uganda,7601,0,1074,1402,10077
2008,Ukraine,185,0,1068,1631,2884
2008,United Arab Emirates,105,5,10,5,125
2008,United Kingdom of Great Britain and Northern Ireland,7276,2292,21678,8672,39918
2008,United Rep. of Tanzania,54,0,0,0,54
2008,United States of America,16686,0,28409,29288,74383
2008,Uruguay,0,0,10,0,10
2008,Vanuatu,5,0,0,0,5
2008,Venezuela (Bolivarian Republic of),287,0,324,0,611
2008,Yemen,1390,0,375,355,2120
2008,Zambia,10,68,55,56,189
2008,Zimbabwe,221,0,0,695,916
2009,Afghanistan,0,0,10,5,15
2009,Algeria,15,0,899,797,1711
2009,Angola,291,0,266,454,1011
2009,Argentina,110,0,461,203,774
2009,Armenia,13,38,107,38,196
2009,Australia,3418,0,4466,2996,10880
2009,Austria,3230,1528,13520,3450,21728
2009,Azerbaijan,36,0,314,11,361
2009,Bahrain,91,0,0,22,113
2009,Bangladesh,28,0,20,0,48
2009,Belarus,23,0,83,41,147
2009,Belgium,2609,601,12840,673,16723
2009,Belize,0,5,0,5,10
2009,Benin,50,0,325,125,500
2009,Bolivia (Plurinational State of),13,0,0,79,92
2009,Bosnia and Herzegovina,0,5,93,58,156
2009,Botswana,48,0,41,15,104
2009,Brazil,244,0,148,0,392
2009,Bulgaria,33,225,366,79,703
2009,Burkina Faso,5,0,32,95,132
2009,Burundi,2630,5,237,5,2877
2009,Cambodia,15,0,83,36,134
2009,Cameroon,1756,0,611,1440,3807
2009,Canada,11151,0,9790,5706,26647
2009,Central African Rep.,350,0,53,0,403
2009,Chad,5,0,126,0,131
2009,China,25,0,5,5,35
2009,"China, Hong Kong SAR",26,0,1097,437,1560
2009,"China, Macao SAR",5,0,0,0,5
2009,Colombia,26,0,301,0,327
2009,Congo,38,0,84,63,185
2009,Costa Rica,451,0,593,0,1044
2009,Cote d'Ivoire,24,0,130,109,263
2009,Croatia,10,0,93,73,176
2009,Cuba,5,0,5,0,10
2009,Cyprus,74,1338,5219,3229,9860
2009,Czechia,165,20,815,716,1716
2009,Denmark,404,417,1141,0,1962
2009,Djibouti,192,0,31,57,280
2009,Ecuador,26324,0,3373,143,29840
2009,Egypt,1350,0,586,2078,4014
2009,El Salvador,0,0,0,41,41
2009,Estonia,0,0,10,0,10
2009,Ethiopia,19140,0,851,1422,21413
2009,Fiji,0,0,5,0,5
2009,Finland,101,1227,362,2512,4202
2009,France,11970,3745,41880,3434,61029
2009,Gabon,5,0,5,98,108
2009,Georgia,5,0,15,5,25
2009,Germany,8103,1580,11324,7697,28704
2009,Ghana,86,0,54,5,145
2009,Greece,36,46,15022,393,15497
2009,Guatemala,0,0,0,30,30
2009,Guinea-Bissau,15,0,29,0,44
2009,Haiti,0,0,0,10,10
2009,Honduras,5,0,0,34,39
2009,Hungary,161,207,1321,4822,6511
2009,Iceland,5,10,5,25,45
2009,India,2025,0,1268,1771,5064
2009,Indonesia,755,0,112,990,1857
2009,Iran (Islamic Rep. of),86,0,94,41,221
2009,Iraq,5,0,0,986,991
2009,Ireland,350,0,5562,1098,7010
2009,Israel,0,0,1109,4607,5716
2009,Italy,2222,7336,12395,1953,23906
2009,Japan,35,505,1938,195,2673
2009,Jordan,364,0,255,275,894
2009,Kazakhstan,264,0,84,5,353
2009,Kenya,3658,0,926,1470,6054
2009,Kuwait,5,0,0,25,30
2009,Kyrgyzstan,171,0,175,256,602
2009,Latvia,5,0,15,5,25
2009,Lebanon,83,0,306,176,565
2009,Liberia,43,0,10,0,53
2009,Libya,1706,0,136,2658,4500
2009,Liechtenstein,0,0,69,175,244
2009,Lithuania,5,30,94,84,213
2009,Luxembourg,97,5,227,191,520
2009,Malawi,534,0,181,3402,4117
2009,Malaysia,35527,158,798,2609,39092
2009,Mali,0,0,0,364,364
2009,Malta,20,1673,1065,136,2894
2009,Mauritania,64,0,210,63,337
2009,Mexico,108,0,232,224,564
2009,Mongolia,0,0,0,5,5
2009,Montenegro,0,0,10,5,15
2009,Morocco,137,0,719,65,921
2009,Mozambique,506,0,266,990,1762
2009,Namibia,141,0,149,23,313
2009,Nepal,15,17,0,25,57
2009,Netherlands,682,7192,8437,0,16311
2009,New Zealand,84,0,276,10,370
2009,Nicaragua,68,0,0,199,267
2009,Niger,0,0,5,5,10
2009,Nigeria,0,0,0,363,363
2009,North Macedonia,0,0,19,86,105
2009,Norway,1784,3118,14231,5165,24298
2009,Oman,19,0,5,35,59
2009,Pakistan,488,0,147,1189,1824
2009,Palau,11,0,0,0,11
2009,Panama,40,0,124,73,237
2009,Papua New Guinea,5,0,5,0,10
2009,Paraguay,15,0,0,5,20
2009,Peru,71,0,32,269,372
2009,Philippines,0,0,0,30,30
2009,Poland,127,2450,4036,9223,15836
2009,Portugal,5,34,36,0,75
2009,Qatar,16,0,0,17,33
2009,Rep. of Korea,68,15,987,202,1272
2009,Rep. of Moldova,0,25,26,0,51
2009,Romania,66,18,769,136,989
2009,Russian Federation,190,2248,3348,0,5786
2009,Rwanda,0,39,96,15,150
2009,Saudi Arabia,10,0,0,143,153
2009,Senegal,15,0,81,0,96
2009,Serbia and Kosovo: S/RES/1244 (1999),0,0,5,309,314
2009,Sierra Leone,0,0,0,176,176
2009,Slovakia,10,88,322,452,872
2009,Slovenia,16,5,77,80,178
2009,Somalia,101,0,30,23,154
2009,South Africa,4565,0,46050,173,50788
2009,Spain,159,158,4108,216,4641
2009,Sri Lanka,59,0,40,98,197
2009,Sudan,10581,0,47,5,10633
2009,Sweden,1810,7468,26409,4376,40063
2009,Switzerland,2604,4035,5740,8936,21315
2009,Syrian Arab Rep.,1184,0,285,72,1541
2009,Tajikistan,910,0,200,0,1110
2009,Thailand,7250,0,1474,420,9144
2009,Timor-Leste,0,0,0,10,10
2009,Togo,15,0,96,313,424
2009,Trinidad and Tobago,5,0,15,32,52
2009,Tunisia,5,0,23,33,61
2009,Turkey,6063,0,1142,2797,10002
2009,Uganda,13115,0,259,4751,18125
2009,Ukraine,293,0,691,481,1465
2009,United Arab Emirates,168,0,25,0,193
2009,United Kingdom of Great Britain and Northern Ireland,9724,2773,30216,6310,49023
2009,United Rep. of Tanzania,46,0,22,224,292
2009,United States of America,19740,0,13332,44143,77215
2009,Uruguay,15,0,0,10,25
2009,Venezuela (Bolivarian Republic of),215,0,226,0,441
2009,Yemen,1559,0,134,251,1944
2009,Zambia,124,0,95,69,288
2009,Zimbabwe,524,0,10,122,656
2010,Afghanistan,10,0,0,10,20
2010,Algeria,16,0,299,79,394
2010,Angola,136,0,0,0,136
2010,Argentina,32,0,409,112,553
2010,Armenia,23,0,30,24,77
2010,Australia,3820,0,5308,130,9258
2010,Austria,2963,1740,13269,2485,20457
2010,Azerbaijan,169,0,159,16,344
2010,Bahamas,0,0,0,5,5
2010,Bahrain,63,0,15,5,83
2010,Bangladesh,10,0,5,0,15
2010,Belarus,20,5,206,25,256
2010,Belgium,2872,859,17091,1548,22370
2010,Belize,0,0,0,15,15
2010,Benin,21,0,112,5,138
2010,Bolivia (Plurinational State of),14,5,0,20,39
2010,Bosnia and Herzegovina,0,0,225,22,247
2010,Botswana,12,0,0,18,30
2010,Brazil,129,0,183,44,356
2010,Bulgaria,20,111,366,275,772
2010,Burkina Faso,0,0,0,15,15
2010,Burundi,4691,349,0,15,5055
2010,Cambodia,5,0,23,10,38
2010,Cameroon,1250,0,566,689,2505
2010,Canada,12279,0,13629,6515,32423
2010,Chad,22,0,5,20,47
2010,Chile,66,0,409,0,475
2010,China,26,0,22,31,79
2010,"China, Hong Kong SAR",78,5,554,336,973
2010,"China, Macao SAR",0,0,10,0,10
2010,Colombia,5,0,21,81,107
2010,Congo,150,0,314,5,469
2010,Costa Rica,148,0,357,672,1177
2010,Cote d'Ivoire,68,0,158,77,303
2010,Croatia,0,5,102,175,282
2010,Cuba,5,0,0,5,10
2010,Curacao ,5,0,0,0,5
2010,Cyprus,51,460,4692,834,6037
2010,Czechia,232,95,616,538,1481
2010,Denmark,766,658,2684,0,4108
2010,Djibouti,133,0,0,156,289
2010,Dominican Rep.,5,0,0,0,5
2010,Ecuador,1376,6525,4087,20067,32055
2010,Egypt,944,0,833,367,2144
2010,El Salvador,5,0,5,69,79
2010,Estonia,10,5,25,0,40
2010,Ethiopia,3143,0,701,2008,5852
2010,Finland,169,1592,1120,2892,5773
2010,France,12556,3051,51229,122,66958
2010,Gabon,0,0,0,183,183
2010,Georgia,10,0,27,15,52
2010,Germany,7668,2645,27235,10515,48063
2010,Ghana,32,0,0,0,32
2010,Greece,89,20,3327,1299,4735
2010,Guatemala,5,0,0,10,15
2010,Guinea,10,0,126,657,793
2010,Haiti,0,0,0,10,10
2010,Honduras,0,0,0,63,63
2010,Hungary,58,168,621,1468,2315
2010,Iceland,0,5,10,5,20
2010,India,3297,0,1517,1722,6536
2010,Indonesia,629,0,20,2933,3582
2010,Iran (Islamic Rep. of),89,0,16,44,149
2010,Iraq,48,0,5,1511,1564
2010,Ireland,134,0,4341,842,5317
2010,Israel,10,0,0,0,10
2010,Italy,1607,1450,7013,0,10070
2010,Japan,47,361,1369,206,1983
2010,Jordan,680,15,665,542,1902
2010,Kazakhstan,66,0,207,70,343
2010,Kenya,7644,0,1083,2382,11109
2010,Kuwait,15,0,24,29,68
2010,Kyrgyzstan,277,0,35,195,507
2010,Latvia,5,16,20,5,46
2010,Lebanon,143,10,514,575,1242
2010,Liberia,170,10,330,0,510
2010,Libya,790,0,17,920,1727
2010,Liechtenstein,0,0,55,44,99
2010,Lithuania,0,15,159,180,354
2010,Luxembourg,64,10,371,201,646
2010,Malawi,522,0,0,400,922
2010,Malaysia,22047,0,526,2320,24893
2010,Mali,25,0,5,5,35
2010,Malta,39,163,154,25,381
2010,Mauritania,29,0,125,0,154
2010,Mexico,216,0,233,489,938
2010,Montenegro,0,0,5,5,10
2010,Morocco,139,0,1042,67,1248
2010,Mozambique,661,0,126,113,900
2010,Namibia,135,0,83,19,237
2010,Nepal,40,5,15,23,83
2010,Netherlands,868,7771,10252,0,18891
2010,New Zealand,102,0,327,20,449
2010,Nicaragua,39,0,0,65,104
2010,Niger,0,0,0,29,29
2010,Nigeria,65,0,104,56,225
2010,North Macedonia,0,0,10,75,85
2010,Norway,3184,2515,17324,3925,26948
2010,Oman,52,0,0,0,52
2010,Pakistan,334,0,334,607,1275
2010,Panama,99,0,132,669,900
2010,Papua New Guinea,0,0,5,0,5
2010,Paraguay,5,0,0,5,10
2010,Peru,32,5,24,313,374
2010,Poland,71,223,1660,3189,5143
2010,Portugal,5,52,0,77,134
2010,Qatar,21,0,0,10,31
2010,Rep. of Korea,38,40,158,52,288
2010,Rep. of Moldova,0,39,25,5,69
2010,Romania,85,32,608,152,877
2010,Russian Federation,118,1029,2927,0,4074
2010,Saudi Arabia,10,0,0,35,45
2010,Senegal,0,0,78,707,785
2010,Serbia and Kosovo: S/RES/1244 (1999),0,0,194,397,591
2010,Sierra Leone,0,0,0,5,5
2010,Slovakia,10,52,147,380,589
2010,Slovenia,20,0,5,160,185
2010,Somalia,163,0,221,415,799
2010,South Africa,10080,0,66962,0,77042
2010,Spain,223,360,1630,106,2319
2010,Sri Lanka,54,0,103,145,302
2010,Sudan,11536,0,267,515,12318
2010,Sweden,2269,7973,29452,4900,44594
2010,Switzerland,3429,4752,2739,10565,21485
2010,Syrian Arab Rep.,1153,153,398,2187,3891
2010,Tajikistan,519,0,174,0,693
2010,Thailand,319,0,370,964,1653
2010,Timor-Leste,0,0,0,5,5
2010,Togo,22,0,15,0,37
2010,Trinidad and Tobago,0,5,0,98,103
2010,Tunisia,5,0,25,37,67
2010,Turkey,6476,0,1941,2382,10799
2010,Uganda,5651,0,583,0,6234
2010,Ukraine,231,42,583,846,1702
2010,United Arab Emirates,385,0,17,15,417
2010,United Kingdom of Great Britain and Northern Ireland,9291,1992,31216,5209,47708
2010,United Rep. of Tanzania,35,0,0,0,35
2010,United States of America,18980,0,10488,40450,69918
2010,Uruguay,0,0,5,5,10
2010,Venezuela (Bolivarian Republic of),260,0,1700,0,1960
2010,Yemen,1083,83,468,911,2545
2010,Zambia,522,0,21,0,543
2010,Zimbabwe,545,0,15,629,1189
2011,Afghanistan,26,0,0,10,36
2011,Albania,0,0,0,10,10
2011,Algeria,10,0,205,287,502
2011,Angola,1073,0,412,0,1485
2011,Argentina,74,29,385,349,837
2011,Armenia,45,0,15,10,70
2011,Australia,5705,0,8719,178,14602
2011,Austria,3566,2017,11548,2090,19221
2011,Azerbaijan,26,5,79,5,115
2011,Bahamas,0,0,0,5,5
2011,Bahrain,0,47,0,0,47
2011,Bangladesh,0,0,5,0,5
2011,Belarus,15,0,101,37,153
2011,Belgium,4146,1318,26395,1830,33689
2011,Benin,147,0,54,0,201
2011,Bolivia (Plurinational State of),21,0,34,0,55
2011,Bosnia and Herzegovina,0,5,91,45,141
2011,Botswana,149,0,51,18,218
2011,Brazil,93,720,303,20,1136
2011,Bulgaria,5,180,345,288,818
2011,Burkina Faso,30,0,0,15,45
2011,Burundi,5439,0,5,195,5639
2011,Cambodia,5,0,10,5,20
2011,Cameroon,688,0,721,858,2267
2011,Canada,12987,0,16107,5125,34219
2011,Central African Rep.,0,0,0,58,58
2011,Chad,5850,0,0,0,5850
2011,Chile,5,67,142,0,214
2011,China,46,5,54,26,131
2011,"China, Hong Kong SAR",31,0,476,379,886
2011,"China, Macao SAR",0,0,0,10,10
2011,Colombia,5,0,65,76,146
2011,Congo,50,0,336,2758,3144
2011,Costa Rica,219,0,383,265,867
2011,Cote d'Ivoire,10,0,211,0,221
2011,Croatia,5,0,77,581,663
2011,Cuba,10,0,0,0,10
2011,Curacao ,0,0,0,5,5
2011,Cyprus,56,40,5712,693,6501
2011,Czechia,108,264,0,0,372
2011,Dem. Rep. of the Congo,0,0,0,15,15
2011,Denmark,936,563,2749,20,4268
2011,Djibouti,49,5,0,153,207
2011,Dominican Rep.,0,0,0,5,5
2011,Ecuador,2662,0,9551,63,12276
2011,Egypt,767,0,568,706,2041
2011,El Salvador,0,0,0,24,24
2011,Eritrea,0,0,0,135,135
2011,Estonia,0,0,46,5,51
2011,Ethiopia,260,0,0,251,511
2011,Fiji,5,0,0,5,10
2011,Finland,168,1090,617,1607,3482
2011,France,8172,2421,63744,0,74337
2011,Gabon,0,0,0,1870,1870
2011,Gambia,0,0,0,154,154
2011,Georgia,21,0,43,10,74
2011,Germany,7065,2544,23699,9924,43232
2011,Ghana,5,0,0,8238,8243
2011,Greece,191,208,9202,17045,26646
2011,Grenada,5,0,0,0,5
2011,Guatemala,5,0,0,5,10
2011,Guinea,205,0,185,136,526
2011,Guinea-Bissau,13,0,5,269,287
2011,Honduras,5,0,0,5,10
2011,Hungary,43,98,717,593,1451
2011,Iceland,0,5,5,30,40
2011,India,3336,0,1096,560,4992
2011,Indonesia,639,0,26,2216,2881
2011,Iran (Islamic Rep. of),105,0,180,1162,1447
2011,Iraq,25,0,0,11,36
2011,Ireland,97,5,3368,282,3752
2011,Israel,107,14,3784,949,4854
2011,Italy,1785,2516,16971,0,21272
2011,Japan,22,241,2617,322,3202
2011,Jordan,371,0,596,776,1743
2011,Kazakhstan,27,0,54,521,602
2011,Kenya,5164,0,1806,894,7864
2011,Kuwait,5,0,0,2392,2397
2011,Kyrgyzstan,145,0,124,101,370
2011,Latvia,5,10,20,92,127
2011,Lebanon,529,0,326,469,1324
2011,Lesotho,5,0,0,0,5
2011,Liberia,10,0,10,5,25
2011,Libya,0,0,0,389,389
2011,Liechtenstein,0,10,16,40,66
2011,Lithuania,5,10,242,126,383
2011,Luxembourg,25,0,1065,453,1543
2011,Malawi,587,0,317,125,1029
2011,Malaysia,11734,0,1632,3955,17321
2011,Mali,42,0,32,0,74
2011,Malta,59,800,1426,127,2412
2011,Mauritania,43,0,41,250,334
2011,Mexico,244,20,0,10,274
2011,Montenegro,0,0,127,75,202
2011,Montserrat,0,0,0,10,10
2011,Morocco,45,0,545,177,767
2011,Mozambique,124,0,0,85,209
2011,Namibia,116,0,112,521,749
2011,Nepal,26,0,0,22,48
2011,Netherlands,813,7500,10138,0,18451
2011,New Zealand,106,0,296,0,402
2011,Nicaragua,10,0,0,26,36
2011,Niger,5,0,36,23,64
2011,Nigeria,36,0,57,379,472
2011,North Macedonia,0,0,0,504,504
2011,Norway,3087,1637,11730,3311,19765
2011,Oman,5,0,0,0,5
2011,Pakistan,433,0,292,723,1448
2011,Panama,145,0,62,855,1062
2011,Papua New Guinea,0,0,5,0,5
2011,Paraguay,5,0,0,0,5
2011,Peru,25,0,35,171,231
2011,Philippines,5,0,0,15,20
2011,Poland,149,403,2730,6762,10044
2011,Portugal,21,30,0,38,89
2011,Qatar,26,5,0,0,31
2011,Rep. of Korea,42,15,494,82,633
2011,Rep. of Moldova,0,15,66,0,81
2011,Romania,61,27,1405,182,1675
2011,Russian Federation,743,0,0,2015,2758
2011,Saudi Arabia,17,0,5,5,27
2011,Senegal,0,0,71,31,102
2011,Serbia and Kosovo: S/RES/1244 (1999),0,0,147,2949,3096
2011,Sierra Leone,0,22,0,142,164
2011,Slovakia,5,95,76,284,460
2011,Slovenia,15,5,159,192,371
2011,Somalia,126,0,0,17991,18117
2011,South Africa,6802,0,37117,0,43919
2011,South Sudan,10,0,138,5,153
2011,Spain,329,635,1807,160,2931
2011,Sri Lanka,22,0,75,0,97
2011,Sudan,9152,0,327,161,9640
2011,Sweden,2855,7917,28676,4711,44159
2011,Switzerland,3694,3060,2250,11382,20386
2011,Syrian Arab Rep.,1053,0,707,1916,3676
2011,Tajikistan,291,0,80,0,371
2011,Thailand,513,0,240,9035,9788
2011,Togo,37,5022,10,0,5069
2011,Trinidad and Tobago,5,0,10,74,89
2011,Tunisia,3576,0,319,57,3952
2011,Turkey,9307,0,672,3552,13531
2011,Turkmenistan,0,0,0,5,5
2011,Uganda,7567,0,2481,0,10048
2011,Ukraine,224,10,525,631,1390
2011,United Arab Emirates,195,5,10,39,249
2011,United Kingdom of Great Britain and Northern Ireland,8240,1690,21748,4228,35906
2011,United Rep. of Tanzania,13,0,5,956,974
2011,United States of America,23485,0,11881,42497,77863
2011,Uruguay,0,0,0,5,5
2011,Venezuela (Bolivarian Republic of),490,0,1165,0,1655
2011,Yemen,1192,0,533,307,2032
2011,Zambia,201,0,43,5,249
2011,Zimbabwe,0,156,153,360,669
2012,Afghanistan,10,0,10,0,20
2012,Albania,5,0,0,5,10
2012,Algeria,15,0,224,369,608
2012,Argentina,125,0,385,219,729
2012,Armenia,155,0,20,51,226
2012,Australia,8330,0,9371,742,18443
2012,Austria,3670,2047,10723,1867,18307
2012,Azerbaijan,38,11,119,21,189
2012,Bahamas,17,0,31,0,48
2012,Bahrain,89,5,0,51,145
2012,Bangladesh,5,0,0,0,5
2012,Belarus,15,0,59,25,99
2012,Belgium,4029,1570,27704,2136,35439
2012,Belize,0,0,38,5,43
2012,Benin,171,0,41,205,417
2012,Bolivia (Plurinational State of),13,5,19,10,47
2012,Bosnia and Herzegovina,0,10,27,5,42
2012,Botswana,83,5,0,37,125
2012,Brazil,176,0,470,5,651
2012,Bulgaria,15,152,437,240,844
2012,Burundi,6420,0,65,5739,12224
2012,Cambodia,12,0,5,10,27
2012,Cameroon,152,0,561,2955,3668
2012,Canada,10285,0,14445,4671,29401
2012,Chad,3960,0,0,5,3965
2012,Chile,10,0,169,0,179
2012,China,47,0,0,5,52
2012,"China, Hong Kong SAR",10,0,548,384,942
2012,"China, Macao SAR",5,0,0,0,5
2012,Colombia,5,0,63,65,133
2012,Congo,17,0,49,72,138
2012,Costa Rica,123,0,327,525,975
2012,Cote d'Ivoire,20,0,190,5,215
2012,Croatia,15,11,178,868,1072
2012,Cuba,59,0,0,0,59
2012,Cyprus,83,40,2545,611,3279
2012,Czechia,50,141,282,301,774
2012,Dem. Rep. of the Congo,62,0,44,104,210
2012,Denmark,1240,712,2908,0,4860
2012,Djibouti,107,0,0,0,107
2012,Dominican Rep.,30,0,28,969,1027
2012,Ecuador,1540,0,15388,0,16928
2012,Egypt,3231,0,321,4743,8295
2012,El Salvador,5,0,0,0,5
2012,Estonia,5,5,36,10,56
2012,Eswatini,10,0,0,0,10
2012,Ethiopia,1185,0,14,511,1710
2012,Finland,549,780,1099,1014,3442
2012,France,7362,2543,69999,0,79904
2012,Gabon,0,0,0,19,19
2012,Gambia,25,0,0,0,25
2012,Georgia,30,10,72,52,164
2012,Germany,8740,8343,30673,13928,61684
2012,Ghana,9192,0,48,891,10131
2012,Greece,199,412,12191,14798,27600
2012,Guatemala,5,0,0,5,10
2012,Guinea,37,40,138,0,215
2012,Honduras,0,0,0,10,10
2012,Hungary,61,284,363,1462,2170
2012,Iceland,0,0,15,53,68
2012,India,2083,0,798,441,3322
2012,Indonesia,1218,0,74,3027,4319
2012,Iran (Islamic Rep. of),69,0,221,138,428
2012,Iraq,63,0,0,219,282
2012,Ireland,93,21,1642,392,2148
2012,Israel,24,0,50,633,707
2012,Italy,1913,6619,13883,0,22415
2012,Japan,21,103,2856,288,3268
2012,Jordan,948,0,883,2670,4501
2012,Kazakhstan,14,0,25,10,49
2012,Kenya,4274,37,2549,7699,14559
2012,Kuwait,106,0,10,423,539
2012,Kyrgyzstan,18,0,36,184,238
2012,Latvia,5,18,80,116,219
2012,Lebanon,488,16,636,772,1912
2012,Lesotho,5,0,0,0,5
2012,Liberia,23,0,540,0,563
2012,Libya,431,0,0,370,801
2012,Liechtenstein,20,0,35,5,60
2012,Lithuania,10,31,311,140,492
2012,Luxembourg,42,5,1962,879,2888
2012,Malawi,159,0,563,3076,3798
2012,Malaysia,13061,0,1342,5044,19447
2012,Mali,23,0,0,2274,2297
2012,Malta,1263,160,200,74,1697
2012,Mauritania,10,5,53,5,73
2012,Mexico,228,27,165,172,592
2012,Mongolia,5,0,0,0,5
2012,Montenegro,0,0,983,465,1448
2012,Morocco,98,20,430,310,858
2012,Mozambique,581,0,0,3741,4322
2012,Namibia,0,0,0,46,46
2012,Nauru,0,0,0,34,34
2012,Nepal,56,1184,154,371,1765
2012,Netherlands,666,5181,8531,0,14378
2012,New Zealand,145,0,283,5,433
2012,Nicaragua,18,0,0,34,52
2012,Nigeria,218,0,126,348,692
2012,North Macedonia,0,0,0,513,513
2012,Norway,3944,1471,11015,2720,19150
2012,Oman,54,0,0,0,54
2012,Pakistan,1676,0,379,216,2271
2012,Panama,138,0,20,1012,1170
2012,Papua New Guinea,5,0,0,0,5
2012,Paraguay,5,0,0,0,5
2012,Peru,139,0,131,96,366
2012,Philippines,22,0,0,25,47
2012,Poland,116,199,2829,8927,12071
2012,Portugal,5,81,0,199,285
2012,Qatar,0,0,5,10,15
2012,Rep. of Korea,73,20,460,407,960
2012,Rep. of Moldova,12,43,40,35,130
2012,Romania,154,115,2078,162,2509
2012,Russian Federation,742,0,1690,0,2432
2012,Rwanda,15108,0,795,0,15903
2012,Senegal,0,0,92,5,97
2012,Serbia and Kosovo: S/RES/1244 (1999),0,0,78,2738,2816
2012,Sierra Leone,0,0,0,5,5
2012,Sint Maarten (Dutch part),0,0,5,0,5
2012,Slovakia,25,101,189,420,735
2012,Slovenia,15,10,159,98,282
2012,Somalia,124,0,76,784,984
2012,South Africa,7930,0,96864,78,104872
2012,South Sudan,0,0,0,82,82
2012,Spain,225,295,2080,25,2625
2012,Sri Lanka,93,0,17,27,137
2012,Sudan,14035,0,125,164,14324
2012,Sweden,4587,9062,28081,7264,48994
2012,Switzerland,2484,1563,3385,17412,24844
2012,Syrian Arab Rep.,411,15,720,471,1617
2012,Tajikistan,473,0,123,10,606
2012,Thailand,486,0,978,346,1810
2012,Togo,171,5791,82,0,6044
2012,Trinidad and Tobago,5,0,0,0,5
2012,Tunisia,340,0,189,102,631
2012,Turkey,10874,0,612,2924,14410
2012,Uganda,8556,0,1261,0,9817
2012,Ukraine,98,121,793,749,1761
2012,United Arab Emirates,170,13,5,5,193
2012,United Kingdom of Great Britain and Northern Ireland,8687,1259,18763,3770,32479
2012,United Rep. of Tanzania,5,0,0,381,386
2012,United States of America,25235,0,10306,46926,82467
2012,Uruguay,5,0,5,32,42
2012,Venezuela (Bolivarian Republic of),1182,0,9856,7406,18444
2012,Yemen,884,0,156,1742,2782
2012,Zambia,331,0,10,173,514
2012,Zimbabwe,205,0,343,536,1084
2013,Afghanistan,0,0,15,0,15
2013,Albania,5,0,0,17,22
2013,Algeria,20,0,1743,693,2456
2013,Angola,0,0,5,1488,1493
2013,Argentina,214,0,327,1035,1576
2013,Armenia,463,0,5,164,632
2013,Australia,5006,0,5868,159,11033
2013,Austria,4122,1817,10353,2148,18440
2013,Azerbaijan,83,0,188,36,307
2013,Bahamas,15,0,71,10,96
2013,Bahrain,17,0,5,17,39
2013,Bangladesh,14,0,0,0,14
2013,Belarus,20,30,117,54,221
2013,Belgium,4240,2399,20213,4178,31030
2013,Belize,0,0,0,66,66
2013,Benin,105,0,5,45,155
2013,Bolivia (Plurinational State of),10,0,5,5,20
2013,Bosnia and Herzegovina,0,43,5,34,82
2013,Botswana,10,0,126,0,136
2013,Brazil,654,0,554,288,1496
2013,Bulgaria,180,2264,340,1490,4274
2013,Burkina Faso,10,10,0,0,20
2013,Burundi,7340,0,10,2941,10291
2013,Cambodia,10,0,0,10,20
2013,Cameroon,87,0,469,375,931
2013,Canada,7794,0,9884,2900,20578
2013,Cayman Islands,5,0,25,0,30
2013,Chad,170,0,0,0,170
2013,Chile,32,15,126,5,178
2013,China,46,0,45,42,133
2013,"China, Hong Kong SAR",33,0,190,504,727
2013,Colombia,5,0,114,141,260
2013,Congo,95,0,0,900,995
2013,Costa Rica,120,0,1125,85,1330
2013,Cote d'Ivoire,42,0,0,0,42
2013,Croatia,5,15,220,1030,1270
2013,Cuba,24,0,0,0,24
2013,Cyprus,35,211,1195,1217,2658
2013,Czechia,91,250,300,305,946
2013,Dem. Rep. of the Congo,616,0,194,839,1649
2013,Denmark,1852,1408,3383,0,6643
2013,Djibouti,81,0,0,0,81
2013,Dominican Rep.,5,0,325,0,330
2013,Ecuador,509,0,8138,2122,10769
2013,Egypt,4119,0,316,66,4501
2013,Eritrea,5,0,0,0,5
2013,Estonia,0,0,38,15,53
2013,Ethiopia,285,0,0,58,343
2013,Finland,553,1243,959,1249,4004
2013,France,9097,2252,71076,2569,84994
2013,Gabon,5,0,5,5,15
2013,Gambia,10,0,0,5,15
2013,Georgia,23,43,223,534,823
2013,Germany,10902,9190,31112,29655,80859
2013,Ghana,115,0,0,1947,2062
2013,Greece,569,797,15556,5902,22824
2013,Guatemala,0,0,0,30,30
2013,Guinea,5,0,0,285,290
2013,Guinea-Bissau,0,0,0,15,15
2013,Haiti,0,0,0,10,10
2013,Honduras,0,0,0,35,35
2013,Hungary,168,177,4181,11312,15838
2013,Iceland,5,10,104,57,176
2013,India,4833,0,601,411,5845
2013,Indonesia,2410,0,374,4793,7577
2013,Iran (Islamic Rep. of),18,0,10,0,28
2013,Iraq,90,0,0,31,121
2013,Ireland,150,20,1627,396,2193
2013,Israel,5,0,900,0,905
2013,Italy,3059,11286,9160,0,23505
2013,Japan,5,150,3288,351,3794
2013,Jordan,3252,0,447,1480,5179
2013,Kazakhstan,73,5,31,10,119
2013,Kenya,6088,0,2566,2563,11217
2013,Kuwait,144,0,10,206,360
2013,Kyrgyzstan,67,0,139,95,301
2013,Latvia,15,21,28,75,139
2013,Lebanon,1702,0,679,453,2834
2013,Liberia,10,0,5,0,15
2013,Libya,1715,0,0,53,1768
2013,Liechtenstein,0,5,0,79,84
2013,Lithuania,0,35,101,114,250
2013,Luxembourg,138,25,859,444,1466
2013,Madagascar,5,0,0,0,5
2013,Malawi,10,0,0,2814,2824
2013,Malaysia,14483,0,1654,6738,22875
2013,Mali,60,0,0,5,65
2013,Malta,1721,248,469,137,2575
2013,Mauritania,23,0,124,480,627
2013,Mexico,245,27,0,0,272
2013,Mongolia,5,0,0,0,5
2013,Montenegro,0,0,386,3070,3456
2013,Montserrat,0,0,0,5,5
2013,Morocco,192,0,723,985,1900
2013,Mozambique,58,0,0,5,63
2013,Namibia,168,0,69,0,237
2013,Nauru,0,0,0,31,31
2013,Nepal,76,0,28,15,119
2013,Netherlands,1653,8908,6841,395,17797
2013,New Zealand,116,0,287,13,416
2013,Nicaragua,74,0,0,22,96
2013,Niger,33,0,15,10,58
2013,Nigeria,222,0,153,491,866
2013,North Macedonia,0,0,0,766,766
2013,Norway,4844,1922,12567,4130,23463
2013,Oman,5,0,0,0,5
2013,Pakistan,2183,0,653,239,3075
2013,Panama,227,0,43,282,552
2013,Papua New Guinea,0,0,0,5,5
2013,Peru,64,0,93,229,386
2013,Philippines,15,0,0,5,20
2013,Poland,187,544,3012,16223,19966
2013,Portugal,0,92,0,355,447
2013,Qatar,39,0,0,22,61
2013,Rep. of Korea,44,5,633,366,1048
2013,Rep. of Moldova,15,83,35,10,143
2013,Romania,404,537,566,93,1600
2013,Russian Federation,36,1638,1961,639,4274
2013,Rwanda,14264,5,0,0,14269
2013,Saudi Arabia,25,0,0,0,25
2013,Senegal,5,0,76,0,81
2013,Serbia and Kosovo: S/RES/1244 (1999),0,10,20,5025,5055
2013,Sierra Leone,0,0,0,38,38
2013,Sint Maarten (Dutch part),0,0,0,5,5
2013,Slovakia,10,32,179,345,566
2013,Slovenia,20,5,116,135,276
2013,Somalia,55,0,83,1332,1470
2013,South Africa,7383,0,63535,1544,72462
2013,South Sudan,5,0,0,20,25
2013,Spain,193,325,1333,0,1851
2013,Sri Lanka,59,0,100,88,247
2013,Sudan,7606,0,466,20,8092
2013,Sweden,7614,19134,24564,7359,58671
2013,Switzerland,3143,3982,7117,16663,30905
2013,Syrian Arab Rep.,484,0,654,488,1626
2013,Tajikistan,289,0,143,22,454
2013,Thailand,1433,0,79,341,1853
2013,Togo,37,0,45,151,233
2013,Tunisia,37,0,22,244,303
2013,Turkey,14167,0,1524,2206,17897
2013,Turks and Caicos Islands,5,0,0,22,27
2013,Uganda,11109,0,2199,9336,22644
2013,Ukraine,222,129,679,225,1255
2013,United Arab Emirates,245,0,19,10,274
2013,United Kingdom of Great Britain and Northern Ireland,9561,1007,18438,4320,33326
2013,United Rep. of Tanzania,489,0,46,15,550
2013,United States of America,21149,0,9627,34662,65438
2013,Uruguay,5,0,5,10,20
2013,Venezuela (Bolivarian Republic of),725,0,2613,0,3338
2013,Yemen,396,0,465,3674,4535
2013,Zambia,759,0,265,563,1587
2013,Zimbabwe,364,0,71,87,522
2014,Afghanistan,30,0,10,0,40
2014,Albania,0,10,0,151,161
2014,Algeria,0,0,945,512,1457
2014,Angola,0,0,37,2052,2089
2014,Argentina,124,0,334,382,840
2014,Armenia,138,0,24,77,239
2014,Australia,2507,0,10587,220,13314
2014,Azerbaijan,73,0,482,98,653
2014,Bahrain,57,0,5,0,62
2014,Belarus,27,317,135,250,729
2014,Belgium,6833,1588,12769,9739,30929
2014,Belize,0,0,0,22,22
2014,Benin,228,0,36,5,269
2014,Bolivia (Plurinational State of),17,0,5,0,22
2014,Bosnia and Herzegovina,5,5,15,36,61
2014,Botswana,0,0,46,0,46
2014,Brazil,2255,0,156,0,2411
2014,British Virgin Islands,0,0,0,15,15
2014,Bulgaria,5153,1832,488,5034,12507
2014,Burkina Faso,27,0,0,746,773
2014,Burundi,6780,0,1505,2347,10632
2014,Cambodia,0,0,5,5,10
2014,Cameroon,4009,0,874,1573,6456
2014,Canada,9918,0,9251,2343,21512
2014,Central African Rep.,0,0,2242,0,2242
2014,Chad,897,0,0,0,897
2014,Chile,19,0,105,0,124
2014,China,76,0,141,142,359
2014,"China, Hong Kong SAR",73,0,90,145,308
2014,Colombia,12,0,64,550,626
2014,Congo,60,44,5,65,174
2014,Costa Rica,173,0,991,530,1694
2014,Cote d'Ivoire,202,0,0,23,225
2014,Croatia,10,5,251,349,615
2014,Cuba,15,0,0,0,15
2014,Curacao ,18,0,14,10,42
2014,Cyprus,85,1147,503,356,2091
2014,Czechia,60,284,297,319,960
2014,Dem. Rep. of the Congo,0,0,20,372,392
2014,Denmark,3890,1752,3462,0,9104
2014,Djibouti,64,0,0,66,130
2014,Dominican Rep.,0,0,25,32,57
2014,Egypt,4282,0,1259,2927,8468
2014,El Salvador,10,0,5,0,15
2014,Estonia,15,0,25,25,65
2014,Eswatini,166,0,0,202,368
2014,Ethiopia,53,0,0,152,205
2014,Fiji,5,0,0,0,5
2014,Finland,488,835,1102,1201,3626
2014,France,16592,4421,84835,10185,116033
2014,Gabon,15,0,25,669,709
2014,Georgia,33,114,246,590,983
2014,Germany,33293,7236,43004,45301,128834
2014,Ghana,138,0,5,99,242
2014,Greece,2054,1738,16264,20850,40906
2014,Guatemala,15,0,0,10,25
2014,Guinea,123,5,156,5,289
2014,Haiti,0,0,0,5,5
2014,Honduras,15,0,0,0,15
2014,Hungary,229,233,4802,24317,29581
2014,Iceland,15,5,55,0,75
2014,India,4341,0,862,798,6001
2014,Indonesia,2455,0,643,3201,6299
2014,Iran (Islamic Rep. of),5,0,0,0,5
2014,Iraq,174,0,19,56,249
2014,Ireland,471,0,1335,1757,3563
2014,Israel,227,0,0,0,227
2014,Italy,3618,16921,14569,20,35128
2014,Japan,10,97,3968,600,4675
2014,Jordan,13747,0,108,828,14683
2014,Kazakhstan,72,0,232,30,334
2014,Kenya,4900,0,1182,64857,70939
2014,Kuwait,74,0,0,10,84
2014,Kyrgyzstan,50,5,205,186,446
2014,Latvia,0,19,56,180,255
2014,Lebanon,8732,0,823,324,9879
2014,Liberia,19,0,0,11,30
2014,Libya,623,0,0,5,628
2014,Liechtenstein,5,0,5,22,32
2014,Lithuania,21,64,92,157,334
2014,Luxembourg,143,35,1693,465,2336
2014,Malawi,85,0,0,525,610
2014,Malaysia,12374,0,2067,3938,18379
2014,Mali,901,0,0,5,906
2014,Malta,230,1238,489,476,2433
2014,Mauritania,362,0,285,375,1022
2014,Mongolia,5,0,0,0,5
2014,Montenegro,0,0,25,2397,2422
2014,Morocco,70,0,823,2120,3013
2014,Mozambique,5,0,0,628,633
2014,Namibia,415,0,0,120,535
2014,Nauru,387,0,105,48,540
2014,Nepal,202,0,96,31,329
2014,Netherlands,2722,10485,6934,0,20141
2014,New Zealand,153,0,294,28,475
2014,Nicaragua,88,0,0,0,88
2014,Niger,0,0,19,45,64
2014,Nigeria,140,0,168,168,476
2014,North Macedonia,11,0,5,804,820
2014,Norway,3801,1241,9803,3018,17863
2014,Oman,10,0,0,0,10
2014,Pakistan,2109,0,4079,258,6446
2014,Panama,62,0,23,313,398
2014,Papua New Guinea,130,0,118,287,535
2014,Paraguay,15,0,5,0,20
2014,Peru,150,0,215,136,501
2014,Philippines,50,0,0,0,50
2014,Poland,265,176,3287,5634,9362
2014,Portugal,20,78,5,177,280
2014,Qatar,5,0,0,0,5
2014,Rep. of Korea,68,527,1166,396,2157
2014,Rep. of Moldova,47,62,16,38,163
2014,Romania,372,361,872,90,1695
2014,Russian Federation,251,250045,5854,16687,272837
2014,Rwanda,31,0,0,0,31
2014,Saudi Arabia,10,0,0,0,10
2014,Senegal,27,0,59,0,86
2014,Serbia and Kosovo: S/RES/1244 (1999),0,5,5,16510,16520
2014,Sierra Leone,5,0,0,20,25
2014,Slovakia,10,101,80,159,350
2014,Slovenia,28,10,91,202,331
2014,Solomon Islands,5,0,0,0,5
2014,Somalia,208,0,172,830,1210
2014,South Africa,9287,0,90975,3044,103306
2014,South Sudan,0,0,0,20,20
2014,Spain,373,1199,2001,0,3573
2014,Sri Lanka,495,0,201,570,1266
2014,Sudan,4254,0,14,6293,10561
2014,Sweden,10636,21634,22350,13781,68401
2014,Switzerland,6182,7911,10070,2481,26644
2014,Syrian Arab Rep.,772,0,833,503,2108
2014,Tajikistan,417,0,399,1939,2755
2014,Thailand,1606,0,440,763,2809
2014,Togo,325,0,0,0,325
2014,Trinidad and Tobago,78,0,22,35,135
2014,Tunisia,97,0,209,241,547
2014,Turkey,22437,0,975,11535,34947
2014,Uganda,17360,0,2140,1644,21144
2014,Ukraine,220,207,472,282,1181
2014,United Arab Emirates,110,0,0,10,120
2014,United Kingdom of Great Britain and Northern Ireland,10685,1017,18751,4039,34492
2014,United Rep. of Tanzania,206,0,343,0,549
2014,United States of America,21756,1691,14884,33509,71840
2014,Uruguay,10,0,5,20,35
2014,Venezuela (Bolivarian Republic of),724,0,2402,0,3126
2014,Yemen,398,0,515,2548,3461
2014,Zambia,800,0,470,21,1291
2014,Zimbabwe,968,0,312,0,1280
2015,Afghanistan,98,0,5,10,113
2015,Albania,44,0,0,195,239
2015,Algeria,69,0,447,554,1070
2015,Angola,113,0,35,10,158
2015,Antigua and Barbuda,15,0,0,0,15
2015,Argentina,105,0,671,244,1020
2015,Armenia,200,0,39,86,325
2015,Aruba,0,0,5,0,5
2015,Australia,3154,0,4544,1438,9136
2015,Austria,14404,2463,13134,7984,37985
2015,Azerbaijan,128,0,483,122,733
2015,Bangladesh,0,0,5,5,10
2015,Belarus,21,877,128,215,1241
2015,Belgium,9358,1669,9572,4178,24777
2015,Belize,34,0,0,0,34
2015,Benin,124,0,0,0,124
2015,Bolivia (Plurinational State of),5,0,38,0,43
2015,Bosnia and Herzegovina,0,5,0,23,28
2015,Botswana,15,0,477,36,528
2015,Brazil,1198,0,426,3504,5128
2015,Bulgaria,4695,882,516,16998,23091
2015,Burkina Faso,118,0,0,0,118
2015,Burundi,3228,0,277,592,4097
2015,Cambodia,13,0,0,5,18
2015,Cameroon,6002,0,1076,5277,12355
2015,Canada,9138,0,6047,777,15962
2015,Cayman Islands,5,0,70,0,75
2015,Central African Rep.,0,49,0,40,89
2015,Chad,1084,0,15,0,1099
2015,Chile,73,0,51,10,134
2015,China,45,0,113,132,290
2015,"China, Hong Kong SAR",5,0,5,0,10
2015,Colombia,15,0,96,370,481
2015,Congo,69,0,0,1927,1996
2015,Costa Rica,261,0,603,96,960
2015,Cote d'Ivoire,104,0,35,10,149
2015,Croatia,20,5,213,83,321
2015,Cuba,90,0,5,10,105
2015,Curacao ,10,0,0,0,10
2015,Cyprus,299,1646,782,522,3249
2015,Czechia,69,394,423,475,1361
2015,Dem. Rep. of the Congo,334,0,34,36,404
2015,Denmark,7802,2382,2725,0,12909
2015,Djibouti,6486,0,0,1268,7754
2015,Dominican Rep.,5,0,0,15,20
2015,Egypt,6884,636,1016,2006,10542
2015,El Salvador,15,0,0,5,20
2015,Estonia,17,53,76,38,184
2015,Eswatini,79,0,0,49,128
2015,Ethiopia,129,0,15,120,264
2015,Fiji,0,0,0,5,5
2015,Finland,1047,438,1251,4128,6864
2015,France,21274,5506,87074,8741,122595
2015,Gabon,0,15,0,10,25
2015,Georgia,65,878,311,777,2031
2015,Germany,138631,4829,109832,91829,345121
2015,Ghana,221,920,25,760,1926
2015,Greece,4973,833,11329,6235,23370
2015,Guatemala,63,0,0,70,133
2015,Guinea,112,0,19,0,131
2015,Honduras,10,0,0,11,21
2015,Hungary,142,342,2893,152243,155620
2015,Iceland,25,16,94,101,236
2015,India,2661,0,1553,1565,5779
2015,Indonesia,2408,0,390,1207,4005
2015,Iran (Islamic Rep. of),5,0,0,0,5
2015,Iraq,5,425,0,921,1351
2015,Ireland,480,0,1691,1618,3789
2015,Israel,165,0,743,0,908
2015,Italy,3554,26012,41715,50,71331
2015,Japan,20,70,5084,972,6146
2015,Jordan,13316,0,77,69,13462
2015,Kazakhstan,132,0,184,99,415
2015,Kenya,4320,1489,102,4102,10013
2015,Kuwait,339,0,0,20,359
2015,Kyrgyzstan,40,0,141,94,275
2015,Latvia,5,18,144,199,366
2015,Lebanon,11018,0,637,1797,13452
2015,Liberia,0,0,0,30,30
2015,Libya,5,0,0,71,76
2015,Liechtenstein,0,5,30,47,82
2015,Lithuania,15,64,84,156,319
2015,Luxembourg,233,33,1067,662,1995
2015,Malawi,3352,0,531,25,3908
2015,Malaysia,8496,0,1222,3726,13444
2015,Mali,472,0,0,215,687
2015,Malta,316,1240,253,115,1924
2015,Mauritania,487,0,307,61,855
2015,Mexico,914,149,1298,1019,3380
2015,Micronesia (Federated States of),5,0,41,0,46
2015,Mongolia,5,0,0,0,5
2015,Montenegro,14,0,0,1616,1630
2015,Morocco,295,0,781,823,1899
2015,Mozambique,0,0,0,2816,2816
2015,Namibia,179,0,0,5,184
2015,Nauru,388,0,227,0,615
2015,Nepal,201,0,65,32,298
2015,Netherlands,15525,418,5533,1335,22811
2015,New Zealand,183,0,233,10,426
2015,Nicaragua,61,0,0,0,61
2015,Niger,18,0,13,0,31
2015,Nigeria,155,0,322,481,958
2015,North Macedonia,0,0,10,3418,3428
2015,Norway,5594,773,7598,3725,17690
2015,Oman,133,0,0,11,144
2015,Pakistan,2493,0,4265,1173,7931
2015,Panama,42,0,14,220,276
2015,Papua New Guinea,307,0,15,0,322
2015,Paraguay,27,0,15,0,42
2015,Peru,196,0,261,0,457
2015,Philippines,47,0,0,10,57
2015,Poland,339,158,2879,8711,12087
2015,Portugal,26,153,20,428,627
2015,Rep. of Korea,36,197,2784,271,3288
2015,Rep. of Moldova,25,143,69,81,318
2015,Romania,235,276,847,101,1459
2015,Russian Federation,104,149541,3766,21,153432
2015,Rwanda,49,0,0,0,49
2015,Saudi Arabia,5,0,0,68,73
2015,Senegal,135,0,0,0,135
2015,Serbia and Kosovo: S/RES/1244 (1999),15,15,0,939,969
2015,Slovakia,5,42,60,113,220
2015,Slovenia,24,10,122,81,237
2015,Somalia,173,0,231,12,416
2015,South Africa,2606,0,76350,4823,83779
2015,South Sudan,29,0,5,52,86
2015,Spain,212,795,1097,0,2104
2015,Sri Lanka,548,0,253,239,1040
2015,Sudan,4548,25,89,61,4723
2015,Sweden,12923,20220,20074,17770,70987
2015,Switzerland,6354,7085,11914,2690,28043
2015,Syrian Arab Rep.,1234,0,1058,309,2601
2015,Tajikistan,270,0,165,0,435
2015,Thailand,1122,0,352,1016,2490
2015,Togo,204,0,0,0,204
2015,Trinidad and Tobago,66,0,37,16,119
2015,Tunisia,30,0,77,173,280
2015,Turkey,15143,0,1188,20808,37139
2015,Turks and Caicos Islands,0,0,0,5,5
2015,Uganda,31983,0,3502,136,35621
2015,Ukraine,281,116,831,519,1747
2015,United Arab Emirates,358,0,0,15,373
2015,United Kingdom of Great Britain and Northern Ireland,15314,1742,28034,5255,50345
2015,United Rep. of Tanzania,194,0,244,0,438
2015,United States of America,23363,601,9515,49515,82994
2015,Uruguay,26,0,10,10,46
2015,Venezuela (Bolivarian Republic of),1211,0,469,0,1680
2015,Yemen,145,0,10,1351,1506
2015,Zambia,2042,0,632,54,2728
2015,Zimbabwe,46,527,118,317,1008
2016,Afghanistan,5,0,0,5,10
2016,Albania,10,19,15,211,255
2016,Algeria,64,0,198,2586,2848
2016,Argentina,162,0,811,123,1096
2016,Armenia,35,0,50,32,117
2016,Australia,6579,0,12888,536,20003
2016,Austria,22291,3669,4160,10965,41085
2016,Azerbaijan,102,0,179,91,372
2016,Bahamas,0,0,0,5,5
2016,Bahrain,34,0,0,10,44
2016,Belarus,0,594,83,160,837
2016,Belgium,12466,3287,10684,4232,30669
2016,Benin,269,0,5,10,284
2016,Bolivia (Plurinational State of),5,0,5,0,10
2016,Bosnia and Herzegovina,0,5,0,30,35
2016,Botswana,5,0,195,39,239
2016,Brazil,931,79,857,0,1867
2016,British Virgin Islands,0,0,0,17,17
2016,Bulgaria,763,583,1018,0,2364
2016,Burkina Faso,93,0,0,0,93
2016,Burundi,5142,0,189,1182,6513
2016,Cambodia,5,0,34,23,62
2016,Cameroon,2903,0,444,2596,5943
2016,Canada,10214,0,4956,1222,16392
2016,Cayman Islands,10,0,151,0,161
2016,Central African Rep.,0,0,0,120,120
2016,Chad,932,0,10,212,1154
2016,Chile,32,0,27,78,137
2016,China,42,0,163,332,537
2016,"China, Hong Kong SAR",10,0,0,0,10
2016,Colombia,35,0,5,95,135
2016,Congo,32,0,0,0,32
2016,Costa Rica,604,0,2818,2050,5472
2016,Cote d'Ivoire,38,0,0,404,442
2016,Croatia,76,14,214,1216,1520
2016,Cuba,45,0,15,10,70
2016,Curacao ,10,0,0,10,20
2016,Cyprus,214,1187,824,672,2897
2016,Czechia,141,304,513,409,1367
2016,Dem. Rep. of the Congo,20,0,29,49,98
2016,Denmark,4456,2880,3918,0,11254
2016,Dominican Rep.,5,0,0,5,10
2016,Ecuador,271,0,1434,0,1705
2016,Egypt,6868,0,4007,7956,18831
2016,El Salvador,0,0,0,5,5
2016,Estonia,75,62,32,10,179
2016,Eswatini,30,0,0,0,30
2016,Ethiopia,163,0,0,454,617
2016,Fiji,0,0,0,5,5
2016,Finland,4569,1789,15601,6152,28111
2016,France,23963,12577,84656,10485,131681
2016,Gabon,0,5,78,11,94
2016,Georgia,41,202,326,674,1243
2016,Germany,263571,179560,196163,126991,766285
2016,Ghana,348,0,49,1257,1654
2016,Greece,3219,5287,14128,21208,43842
2016,Guatemala,72,0,5,190,267
2016,Guinea,67,5,64,62,198
2016,Haiti,5,0,0,5,10
2016,Honduras,0,0,0,10,10
2016,Hungary,154,261,4661,49456,54532
2016,Iceland,42,40,405,405,892
2016,India,3223,0,440,2244,5907
2016,Indonesia,3211,0,384,766,4361
2016,Iran (Islamic Rep. of),0,0,0,36,36
2016,Iraq,95,0,0,124,219
2016,Ireland,726,0,2418,1903,5047
2016,Israel,206,0,2727,523,3456
2016,Italy,4786,30593,54434,0,89813
2016,Jamaica,0,0,0,10,10
2016,Japan,24,97,9604,1497,11222
2016,Jordan,1360,0,57,20,1437
2016,Kazakhstan,72,0,145,5,222
2016,Kenya,5171,524,10,8724,14429
2016,Kuwait,275,0,10,0,285
2016,Kyrgyzstan,36,0,179,49,264
2016,Latvia,48,93,117,113,371
2016,Lebanon,307,0,989,1489,2785
2016,Lesotho,15,0,0,0,15
2016,Liberia,0,5,0,0,5
2016,Libya,25,0,0,122,147
2016,Liechtenstein,16,5,29,0,50
2016,Lithuania,178,10,85,72,345
2016,Luxembourg,748,30,843,535,2156
2016,Madagascar,20,0,0,5,25
2016,Malawi,871,0,121,9378,10370
2016,Malaysia,19899,0,2863,1730,24492
2016,Mali,110,0,5,131,246
2016,Malta,180,1120,225,297,1822
2016,Mauritania,326,0,77,154,557
2016,Mexico,3276,0,1923,2247,7446
2016,Micronesia (Federated States of),0,0,10,0,10
2016,Mongolia,5,0,5,0,10
2016,Montenegro,10,10,20,223,263
2016,Morocco,264,0,915,878,2057
2016,Mozambique,0,0,0,3066,3066
2016,Nepal,67,0,10,0,77
2016,Netherlands,19565,0,7438,9697,36700
2016,New Zealand,153,0,321,30,504
2016,Niger,47,0,0,10,57
2016,Nigeria,104,0,20,15,139
2016,North Macedonia,0,5,41,708,754
2016,Norway,11665,448,11753,5053,28919
2016,Oman,85,0,0,5,90
2016,Pakistan,1271,0,3470,3151,7892
2016,Panama,28,0,5,1907,1940
2016,Papua New Guinea,63,0,133,0,196
2016,Paraguay,32,0,5,15,52
2016,Peru,164,0,161,46,371
2016,Philippines,79,0,5,5,89
2016,Poland,111,148,2993,9685,12937
2016,Portugal,91,246,99,651,1087
2016,Qatar,62,0,0,0,62
2016,Rep. of Korea,47,244,5526,708,6525
2016,Rep. of Moldova,10,28,96,23,157
2016,Romania,589,203,308,394,1494
2016,Russian Federation,33,21986,0,2954,24973
2016,Saint Kitts and Nevis,0,0,5,0,5
2016,Samoa,5,0,0,0,5
2016,Saudi Arabia,15,0,0,0,15
2016,Senegal,36,177,0,0,213
2016,Serbia and Kosovo: S/RES/1244 (1999),15,25,40,835,915
2016,Sierra Leone,0,0,0,5,5
2016,Sint Maarten (Dutch part),0,0,0,5,5
2016,Slovakia,162,10,42,25,239
2016,Slovenia,136,32,311,605,1084
2016,Somalia,276,0,52,161,489
2016,South Africa,3216,0,38907,870968,913091
2016,South Sudan,23,0,5,76,104
2016,Spain,362,6494,2376,0,9232
2016,Sri Lanka,259,0,92,20,371
2016,Sudan,4789,70,86,123,5068
2016,Sweden,17116,50940,32022,28032,128110
2016,Switzerland,5974,6840,4148,14264,31226
2016,Syrian Arab Rep.,759,0,2091,518,3368
2016,Tajikistan,88,0,75,20,183
2016,Thailand,3023,0,1611,1221,5855
2016,Togo,94,0,84,0,178
2016,Trinidad and Tobago,19,0,0,13,32
2016,Tunisia,15,0,5,58,78
2016,Turkey,18410,0,950,26705,46065
2016,Uganda,18752,0,3046,2367,24165
2016,Ukraine,76,42,654,534,1306
2016,United Arab Emirates,325,0,0,0,325
2016,United Kingdom of Great Britain and Northern Ireland,13517,1511,25490,6060,46578
2016,United Rep. of Tanzania,125,0,150,0,275
2016,United States of America,20428,0,12626,54844,87898
2016,Uruguay,15,0,10,68,93
2016,Venezuela (Bolivarian Republic of),1305,0,773,126,2204
2016,Yemen,408,0,131,4541,5080
2016,Zambia,2125,0,460,440,3025
2016,Zimbabwe,0,526,116,155,797
2017,Afghanistan,10,0,10,40,60
2017,Albania,0,5,0,2995,3000
2017,Algeria,86,0,112,1560,1758
2017,Argentina,85,0,1818,473,2376
2017,Armenia,102,0,5,44,151
2017,Australia,7998,0,22805,1634,32437
2017,Austria,21749,7066,5134,6977,40926
2017,Azerbaijan,81,0,215,49,345
2017,Bahamas,0,0,0,5,5
2017,Belarus,0,546,106,72,724
2017,Belgium,9655,2920,11470,454,24499
2017,Benin,247,0,0,0,247
2017,Bosnia and Herzegovina,0,5,10,159,174
2017,Botswana,36,0,29,0,65
2017,Brazil,586,0,695,0,1281
2017,Bulgaria,802,892,2402,9649,13745
2017,Burkina Faso,65,0,0,91,156
2017,Burundi,5585,0,174,1381,7140
2017,Cambodia,5,0,0,124,129
2017,Cameroon,1303,0,549,120,1972
2017,Canada,13084,0,8857,4036,25977
2017,Cayman Islands,11,0,11,10,32
2017,Central African Rep.,15,10,0,0,25
2017,Chad,300,0,0,1327,1627
2017,Chile,90,0,95,269,454
2017,China,78,0,325,207,610
2017,"China, Hong Kong SAR",5,0,0,0,5
2017,Colombia,18,0,5,438,461
2017,Congo,1573,0,0,5,1578
2017,Costa Rica,368,0,2020,922,3310
2017,Cote d'Ivoire,112,0,0,0,112
2017,Croatia,180,19,256,1637,2092
2017,Cuba,15,0,20,10,45
2017,Curacao ,31,0,5,0,36
2017,Cyprus,239,1063,1521,810,3633
2017,Czechia,30,115,619,715,1479
2017,Dem. Rep. of the Congo,99,62,81,427,669
2017,Denmark,1527,1179,5787,0,8493
2017,Ecuador,217,0,595,18580,19392
2017,Egypt,10918,0,5532,7220,23670
2017,Eritrea,10,0,0,0,10
2017,Estonia,41,50,40,15,146
2017,Eswatini,52,0,0,0,52
2017,Ethiopia,124,0,0,146,270
2017,Finland,2510,700,4494,1611,9315
2017,France,25253,17718,103373,1855,148199
2017,Gabon,0,57,1876,5,1938
2017,Gambia,5,0,0,0,5
2017,Georgia,51,32,388,217,688
2017,Germany,147612,146412,279426,175989,749439
2017,Ghana,209,0,0,160,369
2017,Greece,9543,2043,18437,32835,62858
2017,Guatemala,66,0,10,42,118
2017,Guinea,90,0,5,38,133
2017,Guinea-Bissau,5,0,0,10,15
2017,Guyana,5,0,0,0,5
2017,Honduras,10,0,0,0,10
2017,Hungary,105,1100,2869,2036,6110
2017,Iceland,78,31,615,823,1547
2017,India,4446,0,1327,2502,8275
2017,Indonesia,2641,0,533,1724,4898
2017,Iran (Islamic Rep. of),0,0,0,5,5
2017,Iraq,10,0,10,960,980
2017,Ireland,671,113,1289,170,2243
2017,Israel,235,0,3127,3461,6823
2017,Italy,5887,25900,46434,14001,92222
2017,Japan,10,30,12822,2922,15784
2017,Jordan,2239,0,10,188,2437
2017,Kazakhstan,62,0,179,123,364
2017,Kenya,2362,0,0,4640,7002
2017,Kuwait,15,0,5,30,50
2017,Kyrgyzstan,15,0,97,27,139
2017,Latvia,30,229,86,83,428
2017,Lebanon,278,0,830,513,1621
2017,Lesotho,10,0,0,0,10
2017,Libya,164,0,0,0,164
2017,Liechtenstein,15,5,10,90,120
2017,Lithuania,276,10,71,115,472
2017,Luxembourg,1060,35,890,0,1985
2017,Madagascar,17,0,0,28,45
2017,Malawi,15,67,0,1881,1963
2017,Malaysia,18707,0,3892,12359,34958
2017,Mali,446,0,0,246,692
2017,Malta,148,633,153,599,1533
2017,Mauritania,187,0,120,146,453
2017,Mauritius,5,0,0,0,5
2017,Mexico,2819,0,1644,2392,6855
2017,Mongolia,5,0,0,0,5
2017,Montenegro,0,0,57,669,726
2017,Morocco,274,0,854,2177,3305
2017,Mozambique,0,0,0,295,295
2017,Namibia,208,0,175,0,383
2017,Nepal,51,0,0,5,56
2017,Netherlands,7226,606,8131,1649,17612
2017,New Zealand,150,0,317,50,517
2017,Nicaragua,0,0,0,42,42
2017,Niger,0,0,15,78,93
2017,Nigeria,296,211,15,76,598
2017,North Macedonia,0,0,5,128,133
2017,Norway,3956,214,7709,1104,12983
2017,Pakistan,149,0,1515,2298,3962
2017,Palau,5,0,0,0,5
2017,Panama,86,0,38,2650,2774
2017,Paraguay,5,0,5,5,15
2017,Peru,166,0,520,244,930
2017,Philippines,101,5,15,49,170
2017,Poland,135,358,4172,2737,7402
2017,Portugal,110,370,435,0,915
2017,Qatar,15,0,0,0,15
2017,Rep. of Korea,115,314,5595,1176,7200
2017,Rep. of Moldova,0,10,60,15,85
2017,Romania,861,447,1052,2282,4642
2017,Russian Federation,29,10381,0,4489,14899
2017,Rwanda,10,0,0,22,32
2017,Saudi Arabia,15,0,0,0,15
2017,Senegal,87,0,0,45,132
2017,Serbia and Kosovo: S/RES/1244 (1999),0,10,15,324,349
2017,Sierra Leone,0,0,5,0,5
2017,Slovakia,25,15,35,72,147
2017,Slovenia,141,10,449,943,1543
2017,Somalia,872,0,51,27,950
2017,South Africa,2276,0,26158,38114,66548
2017,South Sudan,85,0,0,825,910
2017,Spain,616,4185,7136,1166,13103
2017,Sri Lanka,349,0,0,35,384
2017,Sudan,4522,0,146,638,5306
2017,Suriname,29,0,14,21,64
2017,Sweden,14155,13033,49004,12476,88668
2017,Switzerland,6338,7823,4276,8688,27125
2017,Syrian Arab Rep.,655,0,1263,2601,4519
2017,Tajikistan,56,0,53,17,126
2017,Thailand,1860,0,3079,1201,6140
2017,Togo,10,0,175,0,185
2017,Trinidad and Tobago,192,0,10,15,217
2017,Tunisia,5,0,10,23,38
2017,Turkey,15432,0,843,47692,63967
2017,Uganda,58810,0,7465,2909,69184
2017,Ukraine,76,65,446,630,1217
2017,United Arab Emirates,123,0,5,268,396
2017,United Kingdom of Great Britain and Northern Ireland,12424,1060,25746,5974,45204
2017,United Rep. of Tanzania,718,0,150,0,868
2017,United States of America,26732,0,38871,43555,109158
2017,Uruguay,20,0,19,611,650
2017,Venezuela (Bolivarian Republic of),15,0,80,10,105
2017,Yemen,497,0,0,54,551
2017,Zambia,15580,0,182,1072,16834
2017,Zimbabwe,659,0,246,265,1170
2018,Afghanistan,0,0,5,89,94
2018,Albania,0,10,0,4225,4235
2018,Algeria,149,0,441,409,999
2018,Argentina,127,0,1083,350,1560
2018,Armenia,73,0,47,67,187
2018,Australia,10287,0,27604,5091,42982
2018,Austria,14671,4188,6856,3239,28954
2018,Azerbaijan,49,0,542,42,633
2018,Bahamas,5,0,0,0,5
2018,Bahrain,10,0,0,50,60
2018,Bangladesh,0,0,0,101,101
2018,Belarus,5,845,52,74,976
2018,Belgium,3750,1295,10785,0,15830
2018,Belize,29,0,72,77,178
2018,Benin,160,0,5,0,165
2018,Bosnia and Herzegovina,0,15,61,744,820
2018,Botswana,70,0,10,15,95
2018,Brazil,1074,0,5859,6105,13038
2018,Bulgaria,311,414,1353,1579,3657
2018,Burkina Faso,41,0,0,5,46
2018,Burundi,10695,0,189,1366,12250
2018,Cameroon,2549,0,280,79,2908
2018,Canada,16838,0,13001,4383,34222
2018,Cayman Islands,5,0,10,0,15
2018,Central African Rep.,234,0,11,82,327
2018,Chad,394,0,10,72,476
2018,Chile,175,0,275,1800,2250
2018,China,35,0,211,344,590
2018,"China, Macao SAR",0,0,0,5,5
2018,Colombia,38,0,5,304,347
2018,Congo,770,0,216,0,986
2018,Costa Rica,185,0,2223,1409,3817
2018,Cote d'Ivoire,195,0,10,182,387
2018,Croatia,234,24,247,577,1082
2018,Cuba,0,0,15,0,15
2018,Curacao ,10,0,0,0,10
2018,Cyprus,185,1016,1673,648,3522
2018,Czechia,25,101,1563,899,2588
2018,Dem. Rep. of the Congo,71,0,73,0,144
2018,Denmark,1018,584,2593,0,4195
2018,Djibouti,0,0,0,1052,1052
2018,Dominican Rep.,0,0,0,542,542
2018,Ecuador,4742,0,7097,25,11864
2018,Egypt,8577,294,3300,2232,14403
2018,El Salvador,5,0,5,5,15
2018,Estonia,15,0,55,5,75
2018,Eswatini,73,0,0,0,73
2018,Ethiopia,0,5,0,826,831
2018,Finland,1836,427,2388,1626,6277
2018,France,29018,17900,104081,18268,169267
2018,Gabon,0,0,46,0,46
2018,Georgia,52,28,516,222,818
2018,Germany,56562,48951,140091,143038,388642
2018,Ghana,488,0,0,25,513
2018,Greece,12758,2659,21133,18035,54585
2018,Guatemala,20,0,0,36,56
2018,Guinea,118,0,0,0,118
2018,Guyana,5,0,0,0,5
2018,Haiti,5,0,0,0,5
2018,Honduras,0,0,0,61,61
2018,Hungary,61,278,582,149,1070
2018,Iceland,96,35,486,523,1140
2018,India,1729,0,1304,3909,6942
2018,Indonesia,1499,0,320,537,2356
2018,Iran (Islamic Rep. of),0,0,0,49,49
2018,Iraq,32,0,15,499,546
2018,Ireland,913,199,2682,625,4419
2018,Israel,5,501,5059,4822,10387
2018,Italy,6477,24142,64509,172,95300
2018,Japan,43,40,16514,5077,21674
2018,Jordan,1605,0,83,23,1711
2018,Kazakhstan,28,0,165,38,231
2018,Kenya,5,16576,0,8940,25521
2018,Kuwait,52,0,0,5,57
2018,Kyrgyzstan,36,0,44,10,90
2018,Latvia,22,20,87,51,180
2018,Lebanon,510,0,539,251,1300
2018,Lesotho,14,0,0,0,14
2018,Liberia,5,0,0,0,5
2018,Libya,952,0,15,3536,4503
2018,Liechtenstein,0,0,22,39,61
2018,Lithuania,137,10,129,123,399
2018,Luxembourg,580,45,405,0,1030
2018,Malawi,4796,0,0,3579,8375
2018,Malaysia,21110,0,10012,3944,35066
2018,Mali,9481,0,0,91,9572
2018,Malta,117,509,252,1592,2470
2018,Mauritania,144,0,149,342,635
2018,Mauritius,11,0,0,0,11
2018,Mexico,4439,1458,1313,5066,12276
2018,Montenegro,5,5,10,3083,3103
2018,Morocco,401,0,900,3001,4302
2018,Mozambique,0,0,0,176,176
2018,Namibia,364,0,0,808,1172
2018,Nepal,153,0,15,15,183
2018,Netherlands,3284,370,6659,884,11197
2018,New Zealand,212,0,316,40,568
2018,Niger,1581,0,0,937,2518
2018,Nigeria,220,0,41,0,261
2018,North Macedonia,0,5,10,292,307
2018,Norway,1441,69,2931,706,5147
2018,Oman,0,0,0,166,166
2018,Pakistan,16,0,0,237,253
2018,Panama,84,0,5,4354,4443
2018,Papua New Guinea,5,0,5,0,10
2018,Paraguay,49,0,5,5,59
2018,Peru,556,0,312,1546,2414
2018,Philippines,124,0,25,20,169
2018,Poland,171,229,3791,2014,6205
2018,Portugal,170,395,405,650,1620
2018,Qatar,0,0,0,41,41
2018,Rep. of Korea,110,509,3209,2004,5832
2018,Rep. of Moldova,10,15,37,40,102
2018,Romania,306,337,976,1347,2966
2018,Russian Federation,26,5988,0,2604,8618
2018,Rwanda,35,0,0,199,234
2018,Saint Kitts and Nevis,5,0,0,0,5
2018,Saudi Arabia,113,0,0,78,191
2018,Senegal,76,0,0,1806,1882
2018,Serbia and Kosovo: S/RES/1244 (1999),71,10,15,727,823
2018,Slovakia,5,30,60,62,157
2018,Slovenia,94,0,409,2361,2864
2018,Somalia,459,0,0,18,477
2018,South Africa,650,0,8227,14364,23241
2018,South Sudan,0,61,0,0,61
2018,Spain,605,2554,7437,0,10596
2018,Sri Lanka,281,0,15,37,333
2018,Sudan,3756,0,472,12789,17017
2018,Suriname,10,0,12,31,53
2018,Sweden,6808,4472,37657,9751,58688
2018,Switzerland,6328,8562,4898,6211,25999
2018,Syrian Arab Rep.,274,0,182,3701,4157
2018,Tajikistan,580,0,66,0,646
2018,Thailand,642,0,1149,835,2626
2018,Togo,68,0,94,0,162
2018,Trinidad and Tobago,540,0,11,116,667
2018,Tunisia,25,0,20,35,80
2018,Turkey,4934,0,386,76011,81331
2018,Uganda,20011,0,2433,16975,39419
2018,Ukraine,36,75,487,518,1116
2018,United Arab Emirates,311,0,0,2554,2865
2018,United Kingdom of Great Britain and Northern Ireland,11970,2412,22556,6705,43643
2018,United Rep. of Tanzania,10,0,0,6286,6296
2018,United States of America,35189,0,64185,55874,155248
2018,Uruguay,52,0,55,2344,2451
2018,Venezuela (Bolivarian Republic of),615,0,1400,86,2101
2018,Yemen,255,0,0,2517,2772
2018,Zambia,12383,0,38,246,12667
2018,Zimbabwe,209,10,10,745,974
2019,Afghanistan,0,0,0,65,65
2019,Albania,23,0,0,194,217
2019,Algeria,206,0,437,9312,9955
2019,Argentina,419,0,882,649,1950
2019,Armenia,82,0,31,79,192
2019,Australia,5022,0,20665,3422,29109
2019,Austria,9710,2228,7366,4225,23529
2019,Azerbaijan,42,0,597,95,734
2019,Bahamas,0,0,0,10,10
2019,Bangladesh,10,0,0,5,15
2019,Belarus,10,608,79,24,721
2019,Belgium,3171,531,5088,1913,10703
2019,Belize,0,0,33,1660,1693
2019,Benin,48,0,23,0,71
2019,Bolivia (Plurinational State of),0,0,495,217,712
2019,Bosnia and Herzegovina,5,41,49,978,1073
2019,Botswana,96,0,0,41,137
2019,Brazil,21532,0,584,5703,27819
2019,Bulgaria,475,0,1128,1042,2645
2019,Burkina Faso,29,0,0,5,34
2019,Burundi,8900,68,279,297,9544
2019,Cameroon,1649,0,182,319,2150
2019,Canada,27168,0,21588,4325,53081
2019,Cayman Islands,5,0,10,5,20
2019,Central African Rep.,49,0,174,91,314
2019,Chad,62,0,0,802,864
2019,Chile,20,0,556,3652,4228
2019,China,47,0,133,206,386
2019,"China, Hong Kong SAR",10,0,0,0,10
2019,Colombia,337,0,0,4052,4389
2019,Congo,29,0,163,3556,3748
2019,Costa Rica,1370,0,5386,9099,15855
2019,Cote d'Ivoire,100,0,38,68,206
2019,Croatia,143,0,242,604,989
2019,Cuba,10,0,26,0,36
2019,Curacao ,13,0,5,26,44
2019,Cyprus,155,1147,2773,1570,5645
2019,Czechia,51,88,945,1015,2099
2019,Dem. Rep. of the Congo,11148,0,10,20,11178
2019,Denmark,748,967,2231,0,3946
2019,Djibouti,50,0,0,119,169
2019,Dominican Rep.,0,0,5,0,5
2019,Ecuador,3229,0,5985,3644,12858
2019,Egypt,16796,0,2613,7786,27195
2019,El Salvador,0,0,0,13,13
2019,Estonia,47,5,33,0,85
2019,Eswatini,56,0,0,0,56
2019,Ethiopia,5,0,0,900,905
2019,Fiji,10,0,0,0,10
2019,Finland,2068,440,3245,1580,7333
2019,France,30051,15998,116309,2238,164596
2019,Gabon,0,0,0,29,29
2019,Gambia,0,0,0,143,143
2019,Georgia,43,34,400,339,816
2019,Germany,53973,38567,116014,127826,336380
2019,Ghana,141,0,0,154,295
2019,Greece,16125,4115,21395,22297,63932
2019,Guatemala,29,0,20,59,108
2019,Guinea,346,0,5,47,398
2019,Guyana,0,0,5,0,5
2019,Honduras,45,0,0,41,86
2019,Hungary,20,23,638,44,725
2019,Iceland,99,244,450,786,1579
2019,India,3150,0,1004,3916,8070
2019,Indonesia,226,0,124,605,955
2019,Iraq,10,0,0,2113,2123
2019,Ireland,1121,179,3571,1621,6492
2019,Israel,5,124,3533,5019,8681
2019,Italy,10091,8231,75098,200,93620
2019,Japan,38,38,10920,4421,15417
2019,Jordan,773,0,127,468,1368
2019,Kazakhstan,10,0,261,44,315
2019,Kenya,6305,0,63,6131,12499
2019,Kuwait,36,0,0,5,41
2019,Kyrgyzstan,28,0,27,53,108
2019,Lao People's Dem. Rep.,10,0,0,0,10
2019,Latvia,23,0,97,30,150
2019,Lebanon,153,0,622,7102,7877
2019,Lesotho,73,5,0,0,78
2019,Liberia,10,0,0,20,30
2019,Libya,1069,0,28,17736,18833
2019,Liechtenstein,0,5,5,0,10
2019,Lithuania,80,10,220,161,471
2019,Luxembourg,620,25,510,0,1155
2019,Madagascar,65,0,0,78,143
2019,Malawi,398,0,0,44,442
2019,Malaysia,16441,0,801,1525,18767
2019,Mali,162,0,0,20,182
2019,Malta,30,290,323,1432,2075
2019,Mauritania,928,0,203,325,1456
2019,Mauritius,10,0,0,0,10
2019,Mexico,10825,1245,3024,9614,24708
2019,Mongolia,21,0,0,0,21
2019,Montenegro,5,0,5,1579,1589
2019,Morocco,376,0,773,3183,4332
2019,Mozambique,0,0,0,948,948
2019,Namibia,767,0,0,5,772
2019,Nauru,21,0,0,0,21
2019,Nepal,38,0,5,5,48
2019,Netherlands,4257,557,5919,3277,14010
2019,New Zealand,272,0,273,37,582
2019,Niger,1642,0,128,7439,9209
2019,Nigeria,19374,0,0,212,19586
2019,North Macedonia,0,0,5,361,366
2019,Norway,1717,57,1633,784,4191
2019,Pakistan,50,0,0,192,242
2019,Panama,47,0,10,5604,5661
2019,Papua New Guinea,10,0,0,5,15
2019,Paraguay,750,0,0,0,750
2019,Peru,687,0,245,2669,3601
2019,Philippines,92,0,31,0,123
2019,Poland,137,135,2510,1985,4767
2019,Portugal,180,100,0,996,1276
2019,Qatar,15,0,0,0,15
2019,Rep. of Korea,30,222,5140,4233,9625
2019,Rep. of Moldova,14,15,103,10,142
2019,Romania,332,281,1073,763,2449
2019,Russian Federation,5960,0,0,2030,7990
2019,Rwanda,188,0,0,119,307
2019,Saudi Arabia,122,0,0,44,166
2019,Senegal,83,0,0,78,161
2019,Serbia and Kosovo: S/RES/1244 (1999),53,15,75,2129,2272
2019,Slovakia,5,15,48,167,235
2019,Slovenia,74,0,471,3272,3817
2019,Solomon Islands,0,0,0,5,5
2019,Somalia,253,0,150,177,580
2019,South Africa,1894,0,22116,22142,46152
2019,South Sudan,187,0,0,61,248
2019,Spain,1644,36796,14920,0,53360
2019,Sri Lanka,584,0,24,71,679
2019,Sudan,1844,0,17,7304,9165
2019,Suriname,5,0,29,16,50
2019,Sweden,4197,2556,31233,8197,46183
2019,Switzerland,5532,5002,3929,4593,19056
2019,Syrian Arab Rep.,109,0,15,8020,8144
2019,Tajikistan,1925,0,210,0,2135
2019,Thailand,364,0,378,311,1053
2019,Togo,51,0,62,0,113
2019,Trinidad and Tobago,1609,0,18,145,1772
2019,Tunisia,183,0,20,5,208
2019,Turkey,5445,0,5212,43289,53946
2019,Uganda,46154,0,2758,5258,54170
2019,Ukraine,47,60,731,4673,5511
2019,United Arab Emirates,165,0,0,701,866
2019,United Kingdom of Great Britain and Northern Ireland,16516,2330,16874,5777,41497
2019,United States of America,44614,0,106354,45309,196277
2019,Uruguay,112,0,90,4686,4888
2019,Venezuela (Bolivarian Republic of),248,0,543,0,791
2019,Viet Nam,5,0,0,0,5
2019,Yemen,32,0,23,545,600
2019,Zambia,5742,0,12,335,6089
2019,Zimbabwe,396,0,118,5,519
2020,Afghanistan,61,0,0,23,84
2020,Albania,5,0,0,5,10
2020,Algeria,177,0,249,467,893
2020,Argentina,124,0,314,69,507
2020,Armenia,86,0,63,79,228
2020,Australia,3450,0,21063,4446,28959
2020,Austria,8057,2515,6676,3192,20440
2020,Azerbaijan,498,0,207,15,720
2020,Bahamas,5,0,0,0,5
2020,Bangladesh,19,0,12,0,31
2020,Barbados,0,0,0,5,5
2020,Belarus,15,453,105,27,600
2020,Belgium,4990,1015,17010,0,23015
2020,Belize,0,0,0,10,10
2020,Benin,0,0,0,5,5
2020,Bolivia (Plurinational State of),253,0,288,436,977
2020,Bosnia and Herzegovina,0,33,59,629,721
2020,Botswana,5,0,31,31,67
2020,Brazil,26257,0,504,15,26776
2020,Bulgaria,102,706,1381,437,2626
2020,Burkina Faso,29,0,0,0,29
2020,Burundi,3876,0,926,248,5050
2020,Cambodia,0,0,0,15,15
2020,Cameroon,1464,0,132,3136,4732
2020,Canada,19596,0,16068,3951,39484
2020,Cayman Islands,0,0,0,5,5
2020,Central African Rep.,20,0,5,0,25
2020,Chad,42,0,0,143,185
2020,Chile,5,0,2058,63,2126
2020,China,53,0,196,84,333
2020,Colombia,351,0,5,723,1079
2020,Comoros,0,0,0,14,14
2020,Congo,1075,0,0,5,1080
2020,Costa Rica,3435,0,4528,11739,19702
2020,Cote d'Ivoire,37,0,32,0,69
2020,Croatia,33,0,282,1238,1553
2020,Cuba,10,0,18,0,28
2020,Curacao ,30,0,0,0,30
2020,Cyprus,163,1510,2436,2298,6407
2020,Czechia,39,74,787,532,1432
2020,Dem. Rep. of the Congo,10,0,25,1713,1748
2020,Denmark,315,221,1080,0,1616
2020,Djibouti,631,0,0,10,641
2020,Dominican Rep.,0,0,5,28,33
2020,Ecuador,810,195,0,146,1151
2020,Egypt,14208,0,3871,2034,20113
2020,El Salvador,0,0,0,5,5
2020,Estonia,24,5,36,0,65
2020,Eswatini,5,0,0,0,5
2020,Ethiopia,57,0,0,14,71
2020,Fiji,5,0,0,0,5
2020,Finland,1501,250,1488,1440,4679
2020,France,18868,12267,98520,2137,131792
2020,Georgia,10,18,331,312,671
2020,Germany,63456,20187,68459,119627,271729
2020,Ghana,581,0,23,184,788
2020,Greece,26855,8493,42071,18081,95500
2020,Guatemala,137,0,63,127,327
2020,Guinea,902,0,324,10,1236
2020,Guyana,11,0,0,0,11
2020,Honduras,12,0,0,26,38
2020,Hungary,95,36,335,44,510
2020,Iceland,137,408,325,431,1301
2020,India,1404,0,666,1653,3723
2020,Indonesia,251,0,25,102,378
2020,Iraq,5,0,0,770,775
2020,Ireland,761,76,2260,693,3790
2020,Israel,10,58,4635,4894,9597
2020,Italy,4587,6996,29186,124,40893
2020,Japan,47,44,8704,3119,11867
2020,Jordan,903,0,272,45314,46489
2020,Kazakhstan,5,0,115,12,132
2020,Kenya,3135,0,0,1325,4460
2020,Kuwait,40,0,0,15,55
2020,Kyrgyzstan,10,0,94,35,139
2020,Latvia,10,16,55,30,111
2020,Lebanon,132,0,697,2992,3821
2020,Lesotho,68,0,0,0,68
2020,Liberia,25,0,0,0,25
2020,Libya,820,0,258,7682,8760
2020,Liechtenstein,11,0,5,15,31
2020,Lithuania,73,0,256,266,595
2020,Luxembourg,753,107,407,83,1350
2020,Madagascar,10,0,0,0,10
2020,Malawi,362,0,0,85,447
2020,Malaysia,4097,0,118,3016,7231
2020,Mali,77,0,0,0,77
2020,Malta,57,173,378,1205,1813
2020,Mauritania,1343,0,335,381,2059
2020,Mauritius,0,0,0,5,5
2020,Mexico,15878,1093,5479,4422,26872
2020,Montenegro,10,0,0,810,820
2020,Morocco,220,0,559,1229,2008
2020,Namibia,179,0,0,92,271
2020,Nauru,324,0,0,0,324
2020,Nepal,20,0,12,10,42
2020,Netherlands,7892,809,3806,1819,14326
2020,New Zealand,0,145,256,56,457
2020,Niger,1165,0,77,34918,36160
2020,Nigeria,443,0,52,82,577
2020,North Macedonia,0,5,32,153,190
2020,Norway,1071,57,1233,468,2829
2020,Pakistan,5,0,0,22,27
2020,Panama,34,0,0,5308,5342
2020,Papua New Guinea,0,0,0,29,29
2020,Paraguay,672,0,0,0,672
2020,Peru,1421,0,141,480,2042
2020,Philippines,44,0,10,55,109
2020,Poland,169,233,3745,1040,5187
2020,Portugal,78,10,55,709,472
2020,Rep. of Korea,52,152,6529,5929,12662
2020,Rep. of Moldova,40,10,76,20,146
2020,Romania,305,466,1363,2217,4351
2020,Russian Federation,5577,0,0,2001,7578
2020,Rwanda,70,0,0,158,228
2020,Saudi Arabia,32,0,0,0,32
2020,Senegal,0,0,0,5,5
2020,Serbia and Kosovo: S/RES/1244 (1999),32,5,56,1411,1504
2020,Sint Maarten (Dutch part),5,0,0,0,5
2020,Slovakia,0,35,25,186,246
2020,Slovenia,75,0,652,2890,3617
2020,Somalia,156,0,429,5871,6456
2020,South Africa,12298,0,3458,4801,20557
2020,South Sudan,117,0,0,67,184
2020,Spain,4376,42118,68415,0,114909
2020,Sri Lanka,172,0,34,15,221
2020,Sudan,3909,0,2315,2497,8721
2020,Suriname,15,0,10,171,196
2020,Sweden,3301,1580,25717,5580,36178
2020,Switzerland,5418,4638,3625,2554,16235
2020,Syrian Arab Rep.,15,0,0,3450,3465
2020,Tajikistan,1950,0,145,0,2095
2020,Thailand,382,0,91,75,548
2020,Togo,51,0,69,196,316
2020,Trinidad and Tobago,870,0,13,103,986
2020,Tunisia,305,0,25,107,437
2020,Turkey,8753,0,10674,27086,46513
2020,Turks and Caicos Islands,10,0,5,0,15
2020,Uganda,17301,0,748,2145,20194
2020,Ukraine,39,108,528,339,1014
2020,United Arab Emirates,121,0,0,22,143
2020,United Kingdom of Great Britain and Northern Ireland,9108,1474,8545,6669,25796
2020,United Rep. of Tanzania,50,0,0,1512,1562
2020,United States of America,18177,0,52671,30574,101422
2020,Uruguay,163,0,17,5878,6058
2020,Venezuela (Bolivarian Republic of),343,0,49,0,392
2020,Yemen,10,0,0,709,719
2020,Zambia,5411,0,281,2739,8431
2020,Zimbabwe,203,0,93,137,433
Grand Total,,4356781,1976255,6866198,5551181,18749857
